Adam-and-Eve  | Arum, Lord-and-Ladies, Wake Robin, Starch Root, Bobbins, Cuckoo Plant  |  Arum maculatum |  Araceae
African Wonder Tree  |   |  Ricinus communis |  Euphorbiaceae
Alocasia  | Elephant's Ear  |  Alocasia spp. |  Araceae
Aloe  |   |  Aloe vera |  Liliaceae
Amaryllis  | Many, including: Belladonna lily, Saint Joseph lily, Cape Belladonna, Naked Lady  |  Amaryllis spp. |  Amaryllidaceae
Ambrosia Mexicana  | Jerusalem Oak, Feather Geranium  |  Chenopodium botrys |  Chenopodiaceae
American Bittersweet  | Bittersweet, Waxwork, Shrubby Bittersweet, False Bittersweet, Climbing Bittersweet  |  Celastrus scandens |  Celastraceae
American Holly  | English Holly, European Holly, Oregon Holly, Inkberry, Winterberry  |  Ilex opaca |  Aquifoliaceae
American Mandrake  | Mayapple, Indian Apple Root, Umbrella Leaf, Wild Lemon, Hog Apple, Duck's Foot, Raccoonberry  |  Podophyllum peltatum |  Berberidaceae
American Yew  | Canada Yew, Canadian Yew  |  Taxus canadensus |  Taxaceae
Andromeda Japonica  | Pieris, Lily-of-the-Valley Bush  |  Pieris japonica |  Ericaceae
Angelica Tree  | Hercules' Club, Devil's Walking Stick, Prickly Ash, Prickly Elder  |  Aralia spinosa |  Araliaceae
Apple  | Includes crabapples  |  Malus sylvestrus |  Rosaceae
Apricot  | Group also includes Plum, Peach, Cherry  |  Prunus armeniaca |  Rosaceae
Arrow-Head Vine  | Nephthytis, Green Gold Naphthysis, African Evergreen, Trileaf Wonder  |  Syngonium podophyllum |  Araceae
Arum  | Cuckoo-pint, Lord-and-Ladies, Adam-and-Eve, Starch Root, Bobbins, Wake Robin  |  Arum maculatum |  Araceae
Arum Lily  | Calla Lily, Pig Lily, White Arum, Trumpet Lily, Florist's Calla, Garden Calla  |  Zantedeschia aethiopica |  Araceae
Asian Lily  | Asiatic Lily  |  Lilium asiatica |  Liliaceae
Asparagus Fern  | Asparagus, Emerald Feather, Emerald Fern, Sprengeri Fern, Plumosa Fern, Lace Fern, Racemose Asparagus, Shatavari  |  Asparagus densiflorus cv sprengeri |  Liliaceae
Australian Ivy Palm  | Schefflera, Umbrella Tree, Octopus Tree, Starleaf  |  Brassaia actinophylla |  Araliaceae
Autumn Crocus  | Meadow Saffron  |  Colchicum autumnale |  Liliaceae
Azalea  | Rosebay, Rhododendron  |  Rhododendron spp |  Ericaceae
Baby Doll Ti Plant  | Ti-Plant, Good-Luck Plant, Hawaiian Ti Plant  |  Cordyline terminalis |  Agavaceae
Barbados Aloe  | Medicine Plant, True Aloe  |  Aloe barbadensis |  Aloaceae
Barbados Lily  | Amaryllis, Fire Lily, Lily of the Palace, Ridderstjerne  |  Hippeastrum spp. |  Amaryllidaceae
Barbados Pride  | Peacock Flower, Dwarf Poinciana  |  Caesalpinia pulcherrima | Family:
Barbados Pride 2  | Bird of Paradise, Poinciana, Brazilwood  |  Poinciana gilliesii |  Leguminosae
Bay Laurel  | Sweet Bag, Bay Tree, Tree Laurel, Laurel Tree, Laurel  |  Laurus nobilis |  Lauraceae
Bead Tree  | China Ball Tree, Paradise Tree, Persian Lilac, White Cedar, Japanese Bead Tree, Texas Umbrella Tree, Pride-of-India, Chinaberry Tree  |  Melia azedarach |  Meliaceae
Begonia  | Over 1,000 species and 10,000 hybrids  |  Begonia spp. |  Begoniaceae
Bergamot Orange  | Bergamot, Citrus bergamia  |  Citrus Aurantium |  Rutaceae
Bird of Paradise  | Peacock Flower, Barbados Pride, Poinciana, Pride of Barbados  |  Caesalpinia gilliesii |  Leguminosae
Bird of Paradise 2  | Peacock Flower, Barbados Pride, Poinciana, Pride of Barbados  |  Poinciana gilliesii |  Leguminosae
Bird of Paradise Flower  | Crane Flower, Bird's Tongue Flower  |  Strelitzia reginae |  Strelitziaceae
Bird's Tongue Flower  | Bird of Paradise Flower, Crane Flower  |  Strelitzia reginae |  Strelitziaceae
Bishop’s Weed  | Greater Ammi, False Queen Anne's Lace  |  Ammi majus |  Apiaceae
Bitter Root  | Dogbane Hemp, Indian Hemp  |  Apocynum androsaemifolium |  Apocynaceae
Black Calla  | Solomon's Lily, Wild Calla, Wild Arum  |  Arum palestinum |  Araceae
Black Cherry  |   |  Prunus serotina |  Rosaceae
Black Laurel  | Dog Hobble, Dog Laurel, Fetter Bush, Sierra Laurel  |  Leucothoe spp. |  Ericaceae
Black Nightshade  | Nightshade, Deadly Nightshade  |  Solanum nigrum |  Solanaceae
Bobbins  | Arum, Lord-and-Ladies, Adam-and-Eve, Starch Root, Wake Robin, Cuckoo Plant  |  Arum maculatum |  Araceae
Bog Laurel  | Pale Laurel, Bog Kalmia  |  Kalmia poliifolia |  Ericaceae
Borage  | Starflower  |  Borage officinalis |  Boraginceae
Boxwood  |   |  Buxus spp. |  Buxaceae
Branching Ivy  | English Ivy, Glacier Ivy, Needlepoint Ivy, Sweetheart Ivy, California Ivy  |  Hedera helix |  Araliaceae
Brazilwood  | Bird of Paradise, Poinciana, Barbados Pride  |  Poinciana gilliesii |  Leguminosae
Bread and Butter Plant  | Indian Borage, Spanish Thyme, Coleus, Maratha, Militini, East Indian Thyme  |  Coleus ampoinicus |  Labiatae
Brunfelsia  | Yesterday, Today, Tomorrow, Kiss-Me-Quick, Lady-of-the-Night, Fransiscan Rain Tree  |  Brunfelsia species |  Solanaceae
Buckeye  | Horse Chestnut  |  Aesculus spp |  Hippocastanaceae
Buckwheat  |   |  Fagopyrum spp. |  Polygonaceae
Buddhist Pine  | Yew Pine, Japanese Yew, Southern Yew, Podocarpus  |  Podocarpus macrophylla |  Podocarpaceae
Burning Bush  | Wahoo, Spindle Tree  |  Euonymus atropurpurea |  Celastraceae
Buttercup  | Butter Cress, Figwort  |  Ranunculus spp. |  Ranunculaceae
Butterfly Iris  | Spuria Iris  |  Iris spuria |  Iridaceae
Caladium  | Malanga, Elephant's Ears, Stoplight, Seagull, Mother-in-law Plant, Pink Cloud, Texas Wonder, Angel-Wings, Exposition, Candidum, Fancy-leaved Caladium  |  Caladium hortulanum |  Araceae
Calamondin Orange  |   |  Citrus mitis |  Rutaceae
California Ivy  | Branching Ivy, Glacier Ivy, Needlepoint Ivy, Sweetheart Ivy, English Ivy  |  Hedera helix |  Araliaceae
Calla Lily  | Calla Lily, Pig Lily, White Arum, Trumpet Lily, Florist's Calla, Garden Calla, Arum Lily  |  Zantedeschia aethiopica |  Araceae
Cape Jasmine  | Gardenia  |  Gardenia jasminoides |  Rubiaceae
Caraway  | Meridian Fennel, Persian Cumin  |  Carum carvi |  Umbelliferae
Cardboard Cycad  |   |  Zamia furfuracea |  Cycadaceae
Cardboard Palm  | cycads and zamias  |  Zamia spp. |  Cycadaceae
Cardinal Flower  | Lobelia, Indian Pink  |  Lobelia cardinalis |  Campanulaceae
Carnation  | Pinks, Wild Carnation, Sweet William  |  Dianthus caryophyllus |  Caryophyllaceae
Castor Bean Plant  | Castor Oil Plant, Mole Bean Plant, African Wonder Tree, Castor Bean  |  Ricinus communis |  Euphorbiaceae
Catnip  | Catswort, Catmint  |  Nepeta cataria |  Lamiaceae
Ceriman  | Cutleaf Philodendron, Hurricane Plant, Swiss Cheese Plant, Mexican Breadfruit  |  Monstera deliciosa |  Araceae
Chamomile  | Manzanilla, Garden Chamomile, Roman Chamomile, True Chamomile, Corn Feverfew, Barnyard Daisy, Ground-apple, Turkey-weed  |  Anthemis nobilis |  Compositae
Chandelier Plant  | Mother-In-Law-Plant, Kalanchoe, Devils Backbone, Mother of Millions  |  Kalanchoe tubiflora |  Crassulaceae
Charming Dieffenbachia  |   |  Dieffenbachia amoena |  Araceae
Cherry  |   |  Prunus spp. |  Rosaceae
Chinaberry Tree  | Bead Tree, China Ball Tree, Paradise Tree, Persian Lilac, White Cedar, Japanese Bead Tree, Texas Umbrella Tree, Pride-of-India  |  Melia azedarach |  Meliaceae
Chinese Evergreen  |   |  Aglaonema modestum |  Araceae
Chinese Jade  | Silver Jade Plant, Silver Dollar  |  Crassula arborescens |  Crassulaceae
Chives  |   |  Allium schoenoprasum |  Amaryllidaceae
Choke Cherry  |   |  Prunus virginiana |  Rosaceae
Christmas Rose  | Hellebore, Lenten Rose, Easter Rose  |  Helleborus niger |  Ranunculaceae
Chrysanthemum  | Daisy, Mum; many varieties  |  Chrysanthemum spp. |  Compositae
Clematis  | Virgin’s Bower, Leatherflower  |  Clematis spp. |  Ranunculaceae
Climbing Bittersweet  | Bittersweet, Waxwork, Shrubby Bittersweet, False Bittersweet, Climbing Bittersweet, American Bittersweet  |  Celastrus scandens |  Celastraceae
Climbing Lily  | Gloriosa Lily, Glory Lily, Superb Lily  |  Gloriosa superba |  Liliaceae
Climbing Nightshade  | European Bittersweet, Deadly Nightshade, Violet Bloom, Blue Nightshade, Soda Apple, Poisonous Nightshade, Felonwort, Devil's Apple, Scarlet Berry, Woody Nightshade, Blue Blindweed  |  Solanum dulcamara |  Solanaceae
Clivia Lily  | Kaffir Lily, Clivies, Caffre Lily, Cape Clivia, Klivia  |  Clivia spp. |  Amaryllidaceae
Clusia Rosea  | Clusia  |  Clusia major |  Clusiaceae
Coffee Tree  | Wild Coffee, Geranium-Leaf Aralia  |  Polyscias guilfoylei |  Araliaceae
Coleus  | Indian Borage, Bread and Butter Plant, Spanish Thyme, East Indian Thyme, Stinging Thyme, Country Boarage; many others  |  Coleus ampoinicus |  Labiatae
Common Privet  | Privet, Amur, Wax-leaf  |  Ligustrum vulgare |  Oleaceae
Coontie Palm  | Sago Palm, Cardboard Palm, cycads and zamias  |  Zamia pumila |  Cycadaceae
Copperleaf  | Firestorm, match-me-if-you-can  |  Acalypha godseffiana |  Euphorbiaceae
Cordatum  | Fiddle-Leaf, Horsehead Philodendron, Heartleaf Philodendron, Panda Plant, Split Leaf Philodendron, Fruit Salad Plant, Red Emerald, Red Princess, Saddle Leaf  |  Philodendron oxycardium |  Araceae
Corn Plant  | Corn Plant, Cornstalk Plant, Dracaena, Dragon Tree, Ribbon Plant  |  Dracaena fragrans |  Asparagaceae
Cornstalk Plant  | Corn Plant, Dracaena, Dragon Tree, Ribbon Plant  |  Dracaena fragrans |  Agavaceae
Cow parsnip  | Giant Hogweed  |  Heracleum maximum |  Apiaceae
Cowbane  | Water Hemlock, Poison Parsnip  |  Cicuta species |  Apiaceae
Cuckoo-pint  | Arum, Lord-and-Ladies, Adam-and-Eve, Starch Root, Bobbins, Wake Robin  |  Arum maculatum |  Araceae
Cutleaf Philodendron  | Hurricane Plant, Swiss Cheese Plant, Ceriman, Mexican Breadfruit, Split-leaf Philodendron, Window Leaf Plant  |  Monstera deliciosa |  Araceae
Cycads  | Sago Palm, Fern Palm  |  Cycas and Zamia species |  Cycadaceae
Cyclamen  | Sowbread  |  Cyclamen spp |  Primulaceae
Daffodil  | Narcissus, Jonquil, Paper White  |  Narcissus spp |  Amaryllidaceae
Dahlia  | Many varieties  |  Dahlia species |  Compositae
Daisy  | Chrysanthemum, Mum  |  Chrysanthemum species |  Compositae
Day Lilies  | many varieties   |   |  Hemerocallis spp. |  Xanthorrhoeaceae
Deadly Nightshade  | Nightshade, Black Nightshade, European Bittersweet, Climbing Nightshade  |  Solanum spp |  Solanaceae
Desert Azalea  | Desert Rose, Mock Azalea, Sabi Star, Impala Lily, Kudu Lily  |  Adenium obesum |  Apocynaceae
Desert Rose  | Desert Azalea, Impala Lily, Kudu Lily, Mock Azalea, Sabi Star  |  Adenium obesum |  Apocynaceae
Devil's Backbone  | Mother-In-Law-Plant, Kalanchoe, Chandelier Plant, Mother of Millions  |  Kalanchoe tubiflora |  Crassulaceae
Devils Ivy  | Pothos, Golden Pothos, Taro Vine, Ivy Arum  |  Epipremnum aureum |  Araceae
Dieffenbachia  | Charming Dieffenbachia, Giant Dumb Cane, Tropic Snow, Dumbcane, Exotica, Spotted Dumb Cane, Exotica Perfection  |  Dieffenbachia |  Araceae
Dock  | Sorrel  |  Rumex sp. |  Polygonaceae
Dog Daisy  | Dog Fennel  |  Achillea millefolium |  Compositae
Dog Hobble  | Dog Laurel, Fetter Bush, Black Laurel  |  Leucothoe sp. |  Ericaceae
Dogbane Hemp  | Bitterroot, Indian Hemp  |  Apocynum spp. |  Apocynaceae
Dracaena  | Corn Plant, Cornstalk Plant, Dragon Tree, Ribbon Plant  |  Dracaena spp. |  Agavaceae
Dumbcane  | Charming Dieffenbachia, Giant Dumb Cane, Tropic Snow, Exotica, Spotted Dumb Cane, Exotica Perfection, Dieffenbachia  |  Dieffenbachia |  Araceae
Dwarf Poinciana  | Barbados Pride, Peacock Flower  |  Caesalpinia pulcherrima |  Fabaceae
Easter Lily  |   |  Lilium longiflorum |  Liliaceae
Easter Rose  | Hellebore, Christmas Rose, Lenten Rose  |  Helleborus niger |  Ranunculaceae
Eastern Star  |   |  Dianthus spp. |  Caryophyllaceae
Elephant Ears  | Caladium hortulanum   | Caladium, Taro, Pai, Ape, Cape, Via, Via sori, Malanga  |  Caladium hortulanum |  Araceae
Elephant Ears  | Colocasia esculenta   | Caladium, Malanga  |  Colocasia esculenta |  Araceae
Elephant-Ear Begonia  |   |  Begonia scharfii |  Begoniaceae
Emerald Feather  | Emerald Fern, Asparagus, Asparagus fern, Sprengeri fern, Plumosa fern, Lace fern, Racemose asparagus, Shatavari  |  Asparagus densiflorus |  Liliaceae
English Holly  | European Holly, Oregon Holly, Inkberry, Winterberry, American Holly  |  Ilex aquifolium |  Aquifoliaceae
English Ivy  | Branching Ivy, Glacier Ivy, Needlepoint Ivy, Sweetheart Ivy, California Ivy  |  Hedera helix |  Araliaceae
English Yew  | Western Yew, Pacific Yew, Japanese Yew, Anglo-Japanese Yew  |  Taxus baccata |  Taxaceae
Epazote  | Wormseed, Jusuit's Tea, Mexican Tea, Paico  |  Chenopodium ambrosioides |  Chenopodiaceae
Eucalyptus  | Many cultivars  |  Eucalyptus species |  Myrtaceae
European Bittersweet  | Climbing Nightshade, Deadly Nightshade  |  Solanum dulcamara |  Solanaceae
European Holly  | European Holly, Oregon Holly, Inkberry, Winterberry, American Holly, English Holly  |  Ilex aquifolium |  Aquifoliaceae
Exotica  | Charming Dieffenbachia, Giant Dumb Cane, Tropic Snow, Dumbcane, Spotted Dumb Cane, Exotica Perfection, Dieffenbachia  |  Dieffenbachia amoena |  Araceae
False Bittersweet  | American Bittersweet  |  Celastrus scandens |  Celastraceae
False Queen Anne’s Lace  | Bishop's Weed, Greater Ammi  |  Ammi majus |  Apiaceae
Feather Geranium  | Jerusalem Oak, Ambrosia Mexicana  |  Ambrosia mexicana |  Chenopodiaceae
Fern Palm  | Sago Palm, Cycads  |  Zamia spp. |  Cycadaceae
Fetter Bush  | Dog Laurel, Dog Hobble, Black Laurel  |  Leucothoe spp. |  Ericaceae
Fetterbush  | Staggerberry, Maleberry  |  Lyonia spp. |  Ericaceae
Fiddle-Leaf  | Horsehead Philodendron, Cordatum, Heartleaf Philodendron, Panda Plant, Split Leaf Philodendron, Fruit Salad Plant, Red Emerald, Red Princess, Saddle Leaf  |  Philodendron bipennifolium |  Araceae
Fig  | Weeping Fig, Indian Rubber Plant  |  Ficus benjamina |  Moraceae
Figwort  | Buttercup, Butter Cress, Burwort, Crowfoot burwort  |  Ranunculus acris |  Ranunculaceae
Fire Lily  | Amaryllis, Barbados Lily, Lily of the Palace, Ridderstjerne  |  Hippeastrum spp. |  Amaryllidaceae
Flag  | Iris, Snake Lily, Water Flag  |  Iris species |  Iridaceae
Flamingo Flower  | Flamingo Lily, Tail Flower, Oilcloth Flower, Pigtail Plant, Painter's Pallet  |  Anthurium scherzeranum |  Araceae
Fleabane  | Showy Daisy, Horseweed, Seaside Daisy  |  Erigeron speciosus |  Asteraceae
Florida Beauty  | Gold Dust Dracaena, Spotted Dracaena  |  Dracaena surculosa |  Asparagaceae
Florist's Calla  | Calla Lily, Pig Lily, White Arum, Trumpet Lily, Arum Lily, Garden Calla, Arum Lily  |  Zantedeschia aethiopica |  Araceae
Foxglove  |   |  Digitalis purpurea |  Scrophalariaceae
Foxtail  | Bristly copperleaf, chenille, red hot cat's tail, red cattail, cat's tail  |  Acalypha hispida |  Euphorbiaceae
Franciscan Rain Tree  | Yesterday, Today, Tomorrow, Lady-of-the-Night, Morning-Noon-and-Night, Kiss-Me-Quick  |  Brunfelsia species |  Solanaceae
Garden Calla  | Calla Lily, Pig Lily, White Arum, Trumpet Lily, Florist's Calla, Arum Lily  |  Zantedeschia aethiopica |  Araceae
Garden Chamomile  | Chamomile, Ground Apple, Roman Chamomile  |  Anthemis nobilis |  Asteraceae
Garden Hyacinth  | Hyacinth  |  Hyacinthus orientalis |  Liliaceae
Gardenia  | Cape Jasmine  |  Gardenia jasminoides |  Rubiaceae
Garlic  | Stinking Rose, Rustic Treacle, Camphor of the Poor, Nectar of the Gods, Serpent Garlic, Rocambole  |  Allium sativum |  Liliaceae
Geranium  | Many cultivars  |  Pelargonium species |  Geraniaceae
Geranium-Leaf Aralia  | Wild Coffee, Coffee Tree  |  Polyscias guilfoylei |  Araliaceae
Giant Dracaena  | Palm Lily, Grass Palm  |  Cordyline australis |  Agavaceae
Giant Dumb Cane  | Charming Dieffenbachia, Tropic Snow, Dumbcane, Exotica, Spotted Dumb Cane, Exotica Perfection, Dieffenbachia  |  Dieffenbachia amoena |  Araceae
Giant Hogweed  | Cow Parsnip  |  Heracleum maximum |  Apiaceae
Glacier Ivy  | English Ivy, Branching Ivy, Needlepoint Ivy, Sweetheart Ivy, California Ivy  |  Hedera helix |  Araliaceae
Gladiola  | Many cultivars  |  Gladiolus species |  Iridaceae
Gloriosa Lily  | Glory Lily, Climbing Lily, Superb Lily  |  Gloriosa superba |  Liliaceae
Gold Dieffenbachia  |   |  Dieffenbachia picta |  Araceae
Gold Dust Dracaena  | Florida Beauty  |  Dracaena surculosa |  Agavaceae
Golden Birds Nest  | Snake Plant, Mother-in-Law’s Tongue, Good Luck Plant  |  Sansevieria trifasciata |  Agavaceae
Golden Pothos  | Pothos, Devil's Ivy, Taro Vine, Ivy Arum  |  Epipremnum aureum |  Araceae
Golden Ragwort  | Ragwort  |  Senecio species |  Compositae
Good Luck Plant  | Shamrock Plant, Sorrel  |  Oxalis spp. | Family:
Grapefruit  |   |  Citrus paradisii |  Rutaceae
Grass Palm  | Giant Dracaena, Palm Lily  |  Cordyline australis |  Agavaceae
Greater Ammi  | Bishop's Weed, False Queen Anne's Lace  |  Ammi majus |  Apiaceae
Green Gold Naphthysis  | Nephthytis, Arrow-Head Vine  |  Syngonium podophyllum |  Araceae
Ground Apple  | Chamomile, Garden Chamomile, Roman Chamomile  |  Anthemis nobilis |  Asteraceae
Groundsel  | Ragwort, Senecio  |  Senecio species |  Compositae
Hahn's Self Branching English Ivy  | Branching Ivy, Glacier Ivy, Needlepoint Ivy, Sweetheart Ivy, California Ivy, English Ivy  |  Hedera helix |  Araliaceae
Hashish  | Marijuana, Indian Hemp  |  Cannabis sativa |  Cannabaceae
Hawaiian Ti  | Snake Plant, Giant Dracaena  |  Giant Dracaena |  Agavaceae
Heartleaf Philodendron  | Cordatum, Sweetheart Plant  |  Philodendron hederaceum |  Araceae
Heavenly Bamboo  | Sacred Bamboo, Nandina  |  Nandina domestica |  Berberidaceae
Hellebore  | Christmas Rose, Lenten Rose, Easter Rose  |  Helleborus niger |  Ranunculaceae
Hercules' Club  | Angelica Tree, Devil's Walking Stick, Prickly Ash, Prickly Elder  |  Aralia spinosa |  Araliaceae
Hills of Snow  | Hydrangea, Hortensia, Seven Bark  |  Hydrangea arborescens |  Hydrangeaceae
Holly  | English Holly, European Holly, Oregon Holly, Inkberry, Winterberry, American Holly  |  Ilex opaca |  Aquifoliaceae
Horse Chestnut  | Buckeye, Ohio Buckeye, Fetid Buckeye  |  Aesculus glabra |  Sapindaceae
Horsehead Philodendron  | Horsehead Philodendron, Lacy Tree Philodendron, Selloum, Violin Philodendron, and Fiddle Leaf Philodendron  |  Philodendron bipennifolium |  Araceae
Horseweed  | Showy Daisy, Fleabane, Seaside Daisy  |  Erigeron speciosus |  Asteraceae
Hortensia  | Hydrangea, Hills of Snow, Seven Bark  |  Hydrangea arborescens |  Hydrangeaceae
Hosta  | Plantain Lily, Funkia  |  Hosta plataginea |  Liliaceae
Hurricane Plant  | Cutleaf Philodendron, Swiss Cheese Plant, Ceriman, Mexican Breadfruit  |  Monstera deliciosa |  Araceae
Hyacinth  |   |  Hyacinthus orientalis |  Liliaceae
Hydrangea  | Hortensia, Hills of Snow, Seven Bark  |  Hydrangea arborescens |  Hydrangeaceae
Impala Lily  | Desert Rose, Mock Azalea, Sabi Star, Desert Azalea, Kudu Lily  |  Adenium obesum |  Apocynaceae
Inch Plant  | Speedy Henry  |  Tradescantia flumeninsis |  Commelinaceae
Indian Apple  | Mayapple, Indian Apple Root, Umbrella Leaf, Wild Lemon, Hog Apple, Duck's Foot, Raccoonberry, American Mandrake  |  Podophyllum peltatum |  Berberidaceae
Indian Borage  | Bread and Butter Plant, Country Borage, Spanish Thyme, Coleus, Maratha, Militini, East Indian Thyme  |  Coleus ampoinicus |  Labiatae
Indian Hemp  | Apocynum androsaemifolium   | Dogbane Hemp, Bitter Root  |  Apocynum androsaemifolium |  Apocynaceae
Indian Hemp  | Cannabis sativa   | Marijuana, Hashish  |  Cannabis sativa |  Cannabaceae
Indian Pink  | Lobelia, Cardinal Flower  |  Lobelia cardinalis |  Campanulaceae
Indian Rubber Plant  | Fig, Weeping Fig  |  Ficus benjamina |  Moraceae
Inkberry  | English Holly, European Holly, Oregon Holly, American Holly, Winterberry  |  Ilex opaca |  Aquifoliaceae
Iris  | Flag, Snake Lily, Water Flag  |  Iris species |  Iridaceae
Iron Cross Begonia  |   |  Begonia masoniana | Family:
Ivy Arum  | Pothos, Golden Pothos, Taro Vine, Devil's Ivy  |  Epipremnum aureum |  Araceae
Jack-in-the-pulpit  | Three-leaved indian turnip, Devil's dear, Wake robin, Starch wort, Wild turnip, Dragon root, Bog onion, Pepper turnip, Brown dragon, Memory root  |  Arisaema triphyllum |  Araceae
Jade Plant  | Baby Jade, Dwarf rubber plant, Jade tree, Chinese rubber plant, Japanese rubber plant  |  Crassula argentea |  Crassulaceae
Japanese Show Lily  |   |  Lilium speciosum |  Liliaceae
Japanese Yew  | English Yew, Western Yew, Pacific Yew, Anglo-Japanese Yew  |  Taxus sp. |  Taxaceae
Jerusalem Cherry  | Natal cherry, Winter cherry  |  Solanum pseudocapsicum |  Solanaceae
Jerusalem Oak  | Feather Geranium, Ambrosia Mexicana  |  Ambrosia mexicana |  Chenopodiaceae
Jonquil  | Daffodil, Narcissus, Paper White  |  Narcissus jonquilla |  Amaryllidaceae
Kaffir Lily  | Clivia Lily  |  Clivia minata |  Amaryllidaceae
Kalanchoe  | Mother-In-Law-Plant, Devils Backbone, Chandelier Plant, Mother of Millions  |  Kalanchoe spp |  Crassulaceae
Kiss-me-quick  | Yesterday, Today, Tomorrow, Lady-of-the-Night, Morning-Noon-and-Night, Fransiscan Rain Tree  |  Brunfelsia species |  Solanaceae
Klamath Weed  | St. John's Wort  |  Hypericum perforatum |  Clusiaceae
Kudu Lily  | Desert Azalea, Mock Azalea, Sabi Star, Impala Lily, Desert Rose  |  Adenium obesum |  Apocynaceae
Lace Fern  | Asparagus, Emerald Feather, Emerald Fern, Sprengeri Fern, Plumosa Fern, Asparagus Fern, Racemose Asparagus, Shatavari  |  Asparagus densiflorus cv sprengeri |  Liliaceae
Lacy Tree Philodendron  |   |  Philodendron selloum |  Araceae
Lady-of-the-night  | Yesterday, Today, Tomorrow, Kiss-Me-Quick, Morning-Noon-and-Night, Fransiscan Rain Tree  |  Brunfelsia species |  Solanaceae
Lambkill  | Sheep Laurel  |  Kalmia augustifolia |  Ericaceae
Lantana  | Shrub Verbena, Yellow Sage, Red Sage  |  Lantana camara |  Verbenaceae
Larkspur  |   |  Delphinium species |  Ranunculaceae
Laurel  | Mountain laurel, Spoonwood, Mountain Ivy, Calico Bush, Ivy Bush  |  Kalmia latifolia |  Ericaceae
Lavender  | Common Lavender, English Lavender  |  Lavendula angustifolia |  Lamiaceae
Leatherflower  | Clematis, Virgin's Bower  |  Clematis sp. |  Ranunculaceae
Leek  | Elephant Garlic  |  Allium ampeloprasum |  Liliaceae
Lemon  |   |  Citrus limonia |  Rutaceae
Lemon Grass  | Oil Grass  |  Cymbopogon citratus |  Poaceae
Lemon Verbena  | Lemon Beebrush  |  Aloysia triphylla |  Verbenaceae
Lenten Rose  | Hellebore, Christmas Rose, Easter Rose  |  Helleborus niger |  Ranunculaceae
Lily  |   |  Lilium species |  Liliaceae
Lily of the Palace  | Amaryllis, Fire Lily, Barbados Lily, Ridderstjerne  |  Hippeastrum spp. |  Amaryllidaceae
Lily of the Valley  |   |  Convallaria majalis |  Asparagaceae
Lily-of-the-Valley Bush  | Andromeda Japonica, Pieris  |  Pieris japonica |  Ericaceae
Lime  |   |  Citrus aurantifolia |  Rutaceae
Lobelia  | Cardinal Flower, Indian Pink  |  Lobelia cardinalis |  Campanulaceae
Locust  |   |  Robinia spp. |  Mimosaceae
Lord-and-Ladies  | Arum, Wake Robin, Adam-and-Eve, Starch Root, Bobbins, Cuckoo Plant  |  Arum maculatum |  Araceae
Lovage  | Maggi plant, Smellage  |  Levisticum officinale |  Apiaceae
Madagascar Dragon Tree  |   |  Dracaena marginata |  Asparagaceae
Malanga  | Caladium, Elephant's Ears  |  Colocasia esculenta |  Araceae
Malaysian Dracaena  | Song of India, Pleomele  |  Dracaena reflexa |  Asparagaceae
Maleberry  | Staggerbush, Fetterbush  |  Lyonia sp. |  Ericaceae
Mapleleaf Begonia  |   |  Begonia cleopatra |  Begoniaceae
Marble Queen  | Golden Pothos  |  Scindapsus aureus |  Araceae
Marijuana  | Indian Hemp, Hashish  |  Cannabis sativa |  Cannabaceae
Marjoram  | Knotted Marjoram, Pot Marjoram  |  Origanum majorana |  Lamiaceae
Mauna Loa Peace Lily  | Peace Lily  |  Spathiphyllum |  Araceae
Mayapple  | Indian Apple Root, Umbrella Leaf, Wild Lemon, Hog Apple, Duck's Foot, Raccoonberry, American Mandrake  |  Podophyllum peltatum |  Berberidaceae
Mayweed  | Poison Daisy, Stinking Chamomile  |  Anthemis cotula |  Asteraceae
Meadow Saffron  | Autumn Crocus  |  Colchicum autumnale |  Liliaceae
Medicine Plant  | Aloe, True Aloe, Barbados Aloe  |  |  Aloaceae
Metallic Leaf Begonia  |   |  Begonia metallica |  Begoniaceae
Mexican Breadfruit  | Cutleaf Philodendron, Hurricane Plant, Swiss Cheese Plant, Ceriman, Split-leaf Philodendron, Window Leaf Plant  |  Monstera deliciosa |  Araceae
Milfoil  | Yarrow  |  Achillea millefolium |  Asteraceae
Milkweed  |   |  Asclepias species |  Asclepiadaceae
Mint  | Garden Mint  |  Mentha sp. |  Lamiaceae
Mistletoe "American"  | American Mistletoe  |  Phoradendron flavescens |  Viscaceae
Mock Azalea  | Desert Rose, Desert Azalea, Sabi Star, Impala Lily, Kudu Lily  |  Adenium obesum |  Apocynaceae
Mole Bean Plant  |   |  Ricinus communis |  Euphobiaceae
Morning Glory  |   |  Ipomoea spp |  Convolvulaceae
Morning-Noon-and-Night  | Yesterday, Today, Tomorrow, Kiss-Me-Quick, Lady-of-the-Night, Fransiscan Rain Tree  |  Brunfelsia species |  Solanaceae
Moss Rose  | Wild Portulaca, Rock Moss, Purslane, Pigwee, Pusley  |  Portulaca oleracea |  Portulacaceae
Mother of Millions  | Mother-In-Law-Plant, Kalanchoe, Devils Backbone, Chandelier Plant  |  Kalanchoe tubiflora |  Crassulaceae
Mother-in-Law  |   |  Monstera deliciosa |  Araceae
Mother-In-Law Plant  | Mother of Millions, Kalanchoe, Devils Backbone, Chandelier Plant  |  Kalanchoe tubiflora |  Crassulaceae
Mother-in-Law’s Tongue  | Snake Plant, Golden Bird's Nest, Good Luck Plant  |  Sansevieria trifasciata |  Agavaceae
Mum  | Chrysanthemum, Daisy  |  Chrysanthemum spp. |  Compositae
Naked Lady  |   |  Amaryllis spp. |  Amaryllidaceae
Nandina  | Sacred Bamboo, Heavenly Bamboo  |  Nandina domestica |  Berberidaceae
Narcissus  | Daffodil, Jonquil, Paper White  |  Narcissus spp |  Amaryllidaceae
Nasturtium  | Watercress   | Watercress, Brunnenkress  |  Nasturtium officinale |  Brassicaceae
Needlepoint Ivy  | Branching Ivy, Glacier Ivy, English Ivy, Sweetheart Ivy, California Ivy  |  Hedera helix |  Araliaceae
Nephthytis  | Arrow-Head Vine, Green Gold Naphthysis, African Evergreen, Trileaf Wonder  |  Syngonium podophyllum |  Araceae
Nicotiana  | Tree Tobacco, Tobacco, Mustard Tree  |  Nicotiana glauca |  Solanaceae
Nightshade  | Deadly Nightshade, Black Nightshade  |  Solanum spp |  Solanaceae
Octopus Tree  | Schefflera, Umbrella Tree, Australian Ivy Palm, Starleaf  |  Schefflera or Brassia actinoplylla |  Araliaceae
Oilcloth Flower  | Flamingo Plant, Flamingo Lily, Tail Flower, Pigtail Plant, Flamingo Flower, Painter's Pallet  |  Anthurium scherzeranum |  Araceae
Oleander  | Rose-Bay  |  Nerium oleander |  Apocynaceae
Onion  |   |  Allium cepa |  Liliaceae
Orange  |   |  Citrus sinensis |  Rutaceae
Orange Day Lily  |   |  Hemerocallis graminea |  Liliaceae
Oregano  | Greek Oregano  |  Origanum vulgare hirtum |  Lamiaceae
Oregon Holly  | English Holly, European Holly, Inkberry, American Holly, Winterberry  |  Ilex opaca |  Aquifoliaceae
Ornamental Pepper  | Natal Cherry, Winter Cherry, Jerusalem Cherry  |  Solanum pseudocapsicum |  Solanaceae
Pacific Yew  | English Yew, Western Yew, Japanese Yew, Anglo-Japanese Yew  |  Taxus brevifolia |  Taxaceae
Painter's Pallette  | Flamingo Plant, Flamingo Lily, Tail Flower, Oilcloth Flower, Pigtail Plant, Flamingo Flower  |  Anthurium scherzeranum |  Araceae
Palm Lily  | Giant Dracaena, Grass palm  |  Cordyline australis |  Agavaceae
Panda Plant  | Horsehead Philodendron, Cordatum, Heartleaf Philodendron, Panda Plant, Split Leaf Philodendron, Fruit Salad Plant, Red Emerald, Red Princess, Saddle Leaf , Fiddle-leaf  |  Philodendron bipennifolium |  Araceae
Paper White  | Daffodil, Jonquil, Narcissus  |  Narcissus spp |  Amaryllidaceae
Paraguayan Jasmine  | Yesterday, Today, Tomorrow, Lady-of-the-Night, Morning-Noon-and-Night, Kiss-Me-Quick , Fransiscan Rain Tree  |  Brunfelsia species |  Solanaceae
Parsley  | Italian Parsley, Hamburg Parsley, Turnip-rooted Parsley  |  Petroselinum crispum |  Apiaceae
Peace Begonia  |   |  Begonia rex 'peace' |  Begoniaceae
Peace Lily  | Mauna Loa Peace Lily  |  Spathiphyllum |  Araceae
Peach  | Similar plants: Plum, Apricot, Cherry  |  Prunus persica |  Rosaceae
Peacock Flower  | Barbados Pride, Dwarf Poinciana  |  Caesalpinia pulcherrima |  Fabaceae
Pencil Cactus  | Sticks of Fire  |  Euphorbia tirucalli |  Euphorbiaceae
Peony  |   |  Paeonis officinalis |  Paeniaceae
Periwinkle  | Running Myrtle. Vinca  |  Vinca rosea |  Apocynaceae
Philodendron Pertusum  |   |  Philodendron spp |  Araceae
Pie Plant  | Rhubarb  |  Rheum rhabarbarium |  Polygonaceae
Pieris  | Lily-of-the-Valley Bush, Andromeda Japonica, Fetterbush  |  Pieris japonica |  Ericaceae
Pig Lily  | Calla Lily, Arum Lily, White Arum, Trumpet Lily, Florist's Calla, Garden Calla  |  Zantedeschia aethiopica |  Araceae
Pigtail Plant  | Flamingo Plant, Flamingo Lily, Tail Flower, Oilcloth Flower, Painter's Pallet, Flamingo Flower  |  Anthurium scherzeranum |  Araceae
Pink Pearl  |   |  Begonia semperflorens cultivar |  Begoniaceae
Pinks  | Carnation, Wild Carnation, Sweet William  |  Dianthus caryophyllus |  Caryophyllaceae
Plantain Lily  | Hosta  |  Hosta plantaginea |  Liliaceae
Plum  | similar plants: apricot, peach, cherry  |  Prunus domestica |  Rosaceae
Plumosa Fern  | Asparagus, Emerald Feather, Emerald Fern, Sprengeri Fern, Asparagus Fern, Lace Fern, Racemose Asparagus, Shatavari  |  Asparagus densiflorus cv sprengeri |  Liliaceae
Poinciana  | Peacock Flower, Bird of Paradise, Barbados Pride, Pride of Barbados  |  Caesalpinia gilliessi |  Leguminosae
Poinsettia  |   |  Euphorbia pulcherrima |  Euphorbiaceae
Poison Daisy  | Mayweed, Stinking Chamomile  |  Anthemis cotula |  Asteraceae
Poison Hemlock  | Poison Parsley, Spotted Hemlock, Winter Fern, California Fern, Nebraska Fern, Deadly Hemlock  |  Conium maculatum |  Umbelliferae
Poison Parsnip  | water hemlock, cowbane  |  Cicuta maculata |  Apiaceae
Portulaca  | Wild Portulaca, Rock Moss, Purslane, Pigwee, Pusley, Moss Rose  |  Portulaca oleracea |  Portulacaceae
Pride-of-India  | China Ball Tree, Paradise Tree, Persian Lilac, White Cedar, Japanese Bead Tree, Texas Umbrella Tree, Bead Tree, Chinaberry Tree  |  Melia azedarach |  Meliaceae
Primrose  |   |  Primula vulgaris |  Primulaceae
Privet  | amur, wax-leaf, common privet  |  Ligustrum japonicum |  Oleaceae
Purslane  | Wild Portulaca, Rock Moss, Portulaca, Pigwee, Pusley, Moss Rose  |  Portulaca oleracea |  Portulacaceae
Racemose asparagus  | Asparagus, Emerald Feather, Emerald Fern, Sprengeri Fern, Plumosa Fern, Lace Fern, Asparagus Fern, Shatavari  |  Asparagus densiflorus cv sprengeri |  Liliaceae
Ragwort  | Golden Ragwort, Tansy  |  Senecio species |  Compositae
Ranger's Button  | White Heads  |  Sphenosciadium capitellatum |  Apiaceae
Red Emerald  | Horsehead Philodendron, Cordatum, Heartleaf Philodendron, Panda Plant, Split Leaf Philodendron, Fruit Salad Plant, Fiddle Leaf, Red Princess, Saddle Leaf  |  Philodendron bipennifolium |  Araceae
Red Lily  |   |  Lilium umbellatum |  Liliaceae
Red Princess  | Horsehead Philodendron, Cordatum, Heartleaf Philodendron, Panda Plant, Split Leaf Philodendron, Fruit Salad Plant, Fiddle Leaf, Red Emerald, Saddle Leaf  |  Philodendron bipennifolium |  Araceae
Red-Marginated Dracaena  | straight-marginated dracaena  |  Dracaena marginata |  Agavaceae
Rex Begonia  |   |  Begonia rex |  Begoniaceae
Rhododendron  | Rosebay, Azalea  |  Rhododendron spp |  Ericaceae
Rhubarb  | Pie Plant  |  Rheum rhabarbarium |  Polygonaceae
Ribbon Plant  | Corn Plant, Cornstalk Plant, Dracaena, Dragon Tree  |  Dracaena spp. |  Agavaceae
Ridderstjerne  | Amaryllis, Fire Lily, Lily of the Palace, Barbados Lily  |  Hippeastrum spp. |  Amaryllidaceae
Rock Moss  | Wild Portulaca, Moss Rose, Purslane, Pigwee, Pusley  |  Portulaca oleracea |  Portulacaceae
Roman Chamomile  | Chamomile, Garden Chamomile, Ground Apple  |  Anthemis nobilis |  Asteraceae
Rosary Pea  |   |  Abrus precatorius |  Fabaceae
Rosebay  | Rhododendron, Azalea  |  Rhododendron spp |  Ericaceae
Rubrum Lily  |   |  Lilium speciosum |  Liliaceae
Running Myrtle  | Periwinkle, Vinca  |  Vinca rosea |  Apocynaceae
Sabi Star  | Desert Azalea, Mock Azalea, Desert Rose, Impala Lily, Kudu Lily  |  Adenium obesum |  Apocynaceae
Sacred Bamboo  | Heavenly Bamboo, Nandina  |  Nandina domestica |  Berberidaceae
Saddle Leaf  | Horsehead Philodendron, Cordatum, Heartleaf Philodendron, Panda Plant, Split Leaf Philodendron, Fruit Salad Plant, Red Emerald, Red Princess, Fiddle Leaf  |  Philodendron bipennifolium |  Araceae
Sago Palm  | Coontie Palm, Cardboard Palm, cycads and zamias  |  Cycas revoluta, zamia species |  Cycadaceae
Satin Pothos  | Silk Pothos  |  Scindapsus pictus |  Araceae
Scented Geranium  | Geraniums  |  Pelargonium sp. |  Geranilea
Schefflera  | Umbrella Tree, Australian Ivy Palm, Octopus Tree, Starleaf  |  Schefflera |  Araliaceae
Seaside Daisy  | Showy Daisy, Horseweed, Fleabane  |  Erigeron speciosus |  Asteraceae
Seven Bark  | Hydrangea, Hortensia, Hills of Snow  |  Hydrangea arborescens |  Hydrangeaceae
Shamrock Plant  | Good Luck Plant, Sorrel  |  Oxalis spp. |  Oxalidaceae
Shatavari  | Asparagus, Emerald Feather, Emerald Fern, Sprengeri Fern, Plumosa Fern, Lace Fern, Racemose Asparagus  |  Asparagus densiflorus cv sprengeri |  Liliaceae
Showy Daisy  | Seaside Daisy, Horseweed, Fleabane  |  Erigeron speciosus |  Asteraceae
Silver Dollar  | Silver Jade Plant, Chinese Jade  |  Crassula arborescens |  Crassulaceae
Silver Jade Plant  | Chinese Jade, Silver Dollar  |  Crassula arborescens |  Crassulaceae
Skunk Cabbage  | Skunk Weed, Polecat Weed, Meadow Cabbage, Swamp Cabbage  |  Symplocarpus foetidus |  Araceae
Snake Lilly  | Iris, Flag, Water Flag  |  Iris species |  Iridaceae
Snake Plant  | Golden Bird's Nest, Mother-in-Law’s Tongue, Good Luck Plant  |  Sansevieria trifasciata |  Agavaceae
Solomon’s Lily  | Black Calla, Wild Calla, Wild Arum  |  Arum palestinum |  Araceae
Sorrel  | Common Sorrel, Spinach-Dock, Narrow-leaved Dock, Garden sorrel  |  Rumex scutatus |  Polygonaceae
Sowbread  | Cyclamen  |  Cyclamen spp |  Primulaceae
Spanish Thyme  | Indian Borage, Bread and Butter Plant, Coleus, East Indian Thyme, Stinging Thyme, Country Boarage; many others  |  Coleus ampoinicus |  Labiatae
Spindle Tree  | Wahoo, Burning Bush  |  Euonymus atropurpurea |  Celastraceae
Split Leaf Philodendron  | Horsehead Philodendron, Cordatum, Heartleaf Philodendron, Panda Plant, Fiddle-Leaf, Fruit Salad Plant, Red Emerald, Red Princess, Saddle Leaf  |  Philodendron bipennifolium |  Araceae
Spotted Dumb Cane  | Charming Dieffenbachia, Giant Dumb Cane, Tropic Snow, Dumbcane, Exotica, Exotica Perfection, Dieffenbachia  |  Dieffenbachia amoena |  Araceae
Sprengeri Fern  | Asparagus, Emerald Feather, Emerald Fern, Plumosa Fern, Lace Fern, Racemose Asparagus, Shatavari  |  Asparagus densiflorus cv sprengeri |  Liliaceae
Spring Parsley  |   |  Cymopterus watsonii |  Apiaceae
St. John’s Wort  | Klamath Weed  |  Hypericum perforatum |  Clusiaceae
Staggerbush  | Fetterbush, Maleberry  |  Lyonia sp. |  Ericaceae
Starch Root  | Arum, Lord-and-Ladies, Adam-and-Eve, Wake Robin, Bobbins, Cuckoo Plant  |  Arum maculatum |  Araceae
Stargazer Lily  |   |  Lilium orientalis |  Liliaceae
Starleaf  | Schefflera, Umbrella Tree, Octopus Tree, Australian Ivy Palm  |  Brassaia actinophylla |  Araliaceae
Stinking Chamomile  | Mayweed, Poison Daisy  |  Anthemis cotula |  Asteraceae
Straight-Margined Dracaena  | red-margined dracaena  |  Dracaena marginata |  Agavaceae
Striped Dracaena  | warneckii, janet craig plant  |  Dracaena deremensis |  Agavaceae
Superb Lily  | Glory Lily, Climbing Lily, Gloriosa Lily  |  Gloriosa superba |  Liliaceae
Sweet Cherry  |   |  Prunus avium |  Rosaceae
Sweet William  | Carnation, Wild Carnation, Pinks  |  Dianthus caryophyllus |  Caryophyllaceae
Sweetheart Ivy  | English Ivy, Glacier Ivy, Needlepoint Ivy, Branching Ivy, California Ivy  |  Hedera helix |  Araliaceae
Swiss Cheese Plant  | Cutleaf Philodendron, Hurricane Plant, Ceriman, Mexican Breadfruit  |  Monstera deliciosa |  Araceae
Tahitian Bridal Veil  | Gibasis Geniculata  |  tradescantia multiflora |  Commelinaceae
Tail Flower  | Flamingo Plant, Flamingo Lily, Oilcloth Flower, Pigtail Plant, Painter's Pallet  |  Anthurium scherzeranum |  Araceae
Taro  | Caladium hortulanum   | Caladium, Elephant Ears, Pai, Ape, Cape, Via, Via sori, Malanga  |  Caladium hortulanum |  Araceae
Taro  | Colocasia esculenta   | Caladium, Elephant's Ears, Malanga  |  Colocasia esculenta |  Araceae
Taro Vine  | Golden Pothos, Devil's Ivy, Devil's Vine, Ivy Arum  |  Epipremnum aureum |  Araceae
Tarragon  | French Tarragon, Estragon  |  Artemisia dracunculus |  Asteraceae
Texas Umbrella Tree  | China Ball Tree, Paradise Tree, Persian Lilac, White Cedar, Japanese Bead Tree, Bead Tree, Pride-of-India, Chinaberry Tree  |  Melia azedarach |  Meliaceae
Ti-Plant  | Baby Doll Ti Plant, Hawaiian Ti Plant  |  Cordyline terminalis |  Agavaceae
Tiger Lily  |   |  Lilium tigrinum |  Liliaceae
Tobacco  | Tree Tobacco, Nicotiana, Mustard Tree  |  Nicotiana glauca |  Solanaceae
Tomato Plant  |   |  Lycopersicon spp |  Solanaceae
Tree Philodendron  |   |  Philodendron selloum |  Araceae
Tree Tobacco  | Nicotania, Tobacco, Mustard Tree  |  Nicotiana glauca |  Solanaceae
Tropic Snow  | Charming Dieffenbachia, Giant Dumb Cane, Dumbcane, Exotica, Exotica Perfection, Dieffenbachia  |  Dieffenbachia amoena |  Araceae
True Aloe  | Medicine Plant, Aloe, Barbados Aloe  |  Aloe barbadensis |  Aloaceae
Trumpet Lily  | Calla Lily, Pig Lily, White Arum, Arum Lily, Florist's Calla, Garden Calla, Arum Lily  |  Zantedeschia aethiopica |  Araceae
Tulip  |   |  Tulipa spp. |  Liliaceae
Umbrella Leaf  | Indian Apple Root, American Mandrake, Wild Lemon, Hog Apple, Duck's Foot, Raccoonberry, American Mandrake  |  Podophyllum peltatum |  Berberidaceae
Umbrella Tree  | Schefflera, Australian Ivy Palm, Octopus Tree, Starleaf  |  Brassaia actinophylla |  Araliaceae
Variable Dieffenbachia  |   |  Dieffenbachia picta |  Araceae
Variegated Inch Plant  | Speedy Henry  |  Tradescantia flumeninsis |  Commelinaceae
Variegated Laurel  | speedy henry  |  Tradescantia flumeninsis |  Commelinaceae
Variegated Philodendron  |   |  Scindapsus, Philodendron spp |  Araceae
Vinca  | Periwinkle, Running Myrtle  |  Vinca rosea |  Apocynaceae
Virgin's Bower  | Clematis, Leatherflower  |  Clematis sp. |  Ranunculaceae
Wahoo  | Burning Bush, Spindle Tree  |  Euonymus occidentalis |  Celastraceae
Wake Robin  | Arum, Lord-and-Ladies, Adam-and-Eve, Starch Root, Bobbins, Cuckoo Plant  |  Arum maculatum |  Araceae
Warneckei Dracaena  | Striped Dracaena, Janet Craig Plant  |  Dracaena deremensis |  Asparagaceae
Water Flag  | Iris, Snake Lily, Flag  |  Iris species |  Iridaceae
Water Hemlock  | cowbane, poison parsnip  |  Cicuta maculata |  Apiaceae
Wax-Leaf  | privet, amur, common privet  |  Ligustrum japonicum |  Oleaceae
Weeping Fig  | fig, indian rubber plant  |  Ficus sp. |  Moraceae
Western Yew  | English Yew, Pacific Yew, Japanese Yew, Anglo-Japanese Yew  |  Taxus brevifolia |  Taxaceae
White Heads  | Ranger's Button  |  Sphenosciadium capitellatum |  Apiaceae
Wild Arum  | Black Calla, Wild Calla, Solomon's Lily  |  Arum palestinum |  Araceae
Wild Calla  | Black Calla, Wild Arum, Solomon's Lily  |  Arum palestinum |  Araceae
Wild Carnation  | Carnation, Sweet William, Pinks  |  Dianthus caryophyllus |  Caryophyllaceae
Wild Coffee  | Geranium-Leaf Aralia, Coffee Tree  |  Polyscias guilfoylei |  Araliaceae
Winter Cherry  | Natal Cherry, Jerusalem Cherry  |  Solanum pseudocapsicum |  Solanaceae
Winterberry  | English Holly, European Holly, Oregon Holly, Inkberry, American Holly  |  Ilex opaca |  Aquifoliaceae
Wisteria  |   |  Wisteria spp. |  Fabaceae
Wood Lily  |   |  Lilium umbellatum |  Liliaceae
Yarrow  | Milfoil, Soilder's Woundwort, Dog Daisy Thousand Seal, Devil's Nettle, Old Man's Pepper   |  Achillea millefolium |  Asteraceae
Yellow Oleander  |   |  Thevetia peruviana |  Apocynaceae
Yesterday, Today, Tomorrow  | Morning-Noon-and-Night, Kiss-Me-Quick, Lady-of-the-Night, Fransiscan Rain Tree, Brunfelsia  |  Brunfelsia species |  Solanaceae
Yew  | japanese yew  |  Taxus spp. |  Taxaceae
Yew Pine  | buddhist pine  |  Podocarpus macrophylla |  Podocarpacaea
Yucca  |   |  Yucca spp. |  Agavaceae