Plants Non-Toxic to Cats
Acorn Squash | Similar plants: pumpkin, zucchini  | Cucurbita pepo | Cucurbitaceae
African Daisy | Barberton Daisy, Veldt Daisy, Transvaal Daisy, Gerber Daisy  | Gerbera jamesonii | Compositae
African Violet | Cape Marigold  | Saintpaulia spp. | Gesneriaceae
Algaroba | Kiawe, Mesquite  | Prosopis limensis | Mimosaceae
Aluminum Plant | Watermelon Plant  | Pilea cadieri | Urticaceae
Alumroot | Coral Bells, Heuchera  | Heuchera sanguinea | Saxifragaceae
Alyssum | Alyssum varieties  | Alyssum spp. | Brassicaceae
American Rubber Plant | Pepper Face, Baby Rubber Plant  | Peperomia obtusifolia | Pipericeae
Amur Maple | Maple, Amur  | Acer ginnala | Sapindaceae
Anthericum Comosum | Ribbon Plant, Spider Plant, Spider Ivy  | Chlorophytum comosum | Asparagaceae
Antirrhinum Multiflorum | Withered Snapdragon  | Antirrhinum multiflorum | Scrophulariaceae
Arabian Gentian | Persian Violet, German Violet  | Exacum affine | Gentianaceae
Areca Palm | Golden Butterfly Palm, Cane Palm, Golden Feather Palm, Yellow Palm  | Dypsis lutescens | Palmae
Aregelia | Crimson cup, Marbled fingernail,Blushing bromeliad, Ossifragi Vase, Miniature Marble plant  | Neoregalia spp. | Bromeliaceae
Artillery Plant |   | Pilea microphylla | Urticaceae
Aspidium falcatum | Fern Holly, Japanese Holly, Fish Tail  | Cyrtomium falcatum | Polypodiaceae
Australian Pine | Norfolk Pine, House Pine, Norfolk Island Pine  | Araucaria heterophylla | Araucariaceae
Autumn Olive | Silver Berry, Russian Olive  | Eleagnus spp. | Elaeagnaceae
Baby Rubber Plant | Pepper Face, American Rubber Plant  | Peperomia obtusifolia | Pipericeae
Baby’s Breath | Maidens Breath  | Gypsophila elegans | Caryophyllaceae
Baby’s Tears | Polka Dot Plant, Measles Plant, Flamingo Plant, Freckle Face, Pink Splash  | Hypoestes phyllostachya | Acanthaceae
Bachelors Buttons | Cornflower, Bluebottle  | Centaurea cyanus | Asteraceae
Ball Fern | Rabbit's Foot Fern, Squirrel Foot Fern, Deer Foot Fern, Hare Fern  | Davallia spp. | Polypodiaceae
Bamboo | Golden Bamboo, Fishpole Bamboo  | Phyllostachys aurea | Gramineae
Bamboo Palm | Miniature Fish Tail Dwarf Palm, Parlor Palm, Good Luck Palm  | Chamaedorea elegans | Palmae
Bamboo Vine | Blaspheme vine, Laurel-leaved Greenbrier  | Smilax laurifolia | Liliaceae
Banana | Plantain  | Musa acuminata | Musaceae
Banana Squash |   | Cucurbita maxima var. banana | Cucurbitaceae
Barberton Daisy | Transvaal Daisy, African Daisy, Veldt Daisy, Gerbera Daisy  | Gerbera jamesonii | Compositae
Barnaby's Thistle | Yellow Star Thistle  | Centaurea solstitialis | Compositae
Basil | Saint Joseph's Wort, Thai Basil, Sweet Basil  | Ocimum basilicum | Lamiacea
Beets | Beet Root, Red Beet, Swiss Chard, Roman Kale, Sugar Beet  | Beta vulgaris | Chenopodiaceae
Begonia, Climbing | Rex Begonia  | Cissus dicolor | Vitaceae
Begonia, Trailing | Trailing Watermelon Begonia  | Pellionia daveauana | Urticaceae
Belmore Sentry Palm | Curly Palm  | Howea belmoreana | Palmae
Big Shagbark Hickory | Big Shellbark Hickory, Shellbark Hickory, Shagbark Hickory  | Carya laciniosa | Juglandaceae
Big Shellbark Hickory | Shellbark Hickory  | Carya laciniosa | Juglandaceae
Bitter Pecan | Water Hickory  | Carya aquatica | Juglandaceae
Bitternut |   | Carya cordiformis | Juglandaceae
Black Haw | Wild Raisin, Tea Plant, Cowberry, Nannyberry, Sweet Viburnum, Nanny Plum, Sheepberry, Sweetberry  | Viburnum lentago | Caprifoliaceae
Black Hawthorn | Weisdornbluten, Blackthorn, Thorn Apple, Thorn Plum, Pirliteiro, Red Hawthorn, May Bush, Oxyacantha, Haw Apple, Black Haw, Aubepine  | Crataegus douglasii | Rosaceae
Black Walnut |   | Juglans nigra | Juglandaceae
Blackjack Pine | Ponderosa Pine, Western Yellow Pine, Yellow Pine, Bull Pine  | Pinus ponderosa | Pinaceae
Blaspheme Vine | Blaspheme vine, Laurel-leaved Greenbrier, Bamboo Vine  | Smilax laurifolia | Liliaceae
Bloodleaf | Chicken Gizzard, Yellow Bloodleaf, Joseph's Coat  | Iresine herbstii | Amaranthaceae
Blooming Sally | Willow Herb, Great Willow Herb, Fire Weed  | Epilobium angustifolium | Onagraceae
Blue Bead | Corn Lily  | Clintonia borealis | Liliaceae
Blue Daisy | Felicia, Blue Marguerite  | Felicia amelloides | Compositae
Blue Echeveria | Maroon Chenille Plant, Painted Lady, Copper Rose, Wax Rosette, Plush Plant  | Echeveria glauca | Crassulaceae
Blue Eyed Daisy | Blue-eyed African Daisy  | Arctotis stoechadifolia | Compositae
Blue-dicks | Wild Hyacinth  | Dichelostemma pulchellum | Amaryllidaceae
Blue-dicks 2 | Wild Hyacinth  | Hookera pulchella | Amaryllidaceae
Blue-dicks 3 | Wild Hyacinth  | Brodiaea pulchella | Amaryllidaceae
Blue-eyed African Daisy | Blue-eyed Daisy  | Arctotis stoechadifolia | Compositae
Bluebottle | Cornflower, Bachelors Buttons  | Centaurea cyanus | Asteraceae
Blunt Leaf Peperomia | Pepper Face, Baby Rubber Plant, American Rubber Plant  | Peperomia obtusifolia | Pipericeae
Blushing Bromeliad | Crimson cup, Marbled fingernail, Blushing Bromeliad, Ossifragi Vase, Miniature Marble plant, Aregelia  | Neoregalia spp. | Bromiliaceae
Bold Sword Fern |   | Nephrolepis biserrata | Dryopteridaceae
Boston Fern |   | Nephrolepis exalta bostoniensis | Dryopteridaceae
Bottle Palm | Elephant-foot Tree, Pony Tail Plant  | Beaucarnea recurvata | Agavaceae
Bottle Palm 2 | Elephant-foot Tree, Pony Tail Plant  | Nolina tuberculata | Agavaceae
Bottlebrush | Weeping Bottlebrush, Prickly Bottlebrush, Crimson Bottlebrush  | Callistemon species | Myrtaceae
Brazilian Orchid |   | Sophronitis spp. | Orchidaceae
Bride's Bonnet | Queencup  | Clintonia uniflora | Liliaceae
Bristly Greenbrier | Hagbrier, Hellfetter  | Smilax hispida | Liliaceae
Brodiaea Pulchella | Wild Hyacinth, Blue-dicks  | Dichelostemma pulchellum | Amaryllidaceae
Broom Hickory | Big Shellbark Hickory, Shellbark Hickory  | Carya laciniosa | Juglandaceae
Bullbrier | Catbrier, Horsebrier, Common Greenbrier  | Smilax rotundifolia | Liliaceae
Bur Gourd | Goareberry Gourd, Gooseberry Gourd, West Indian Gherkin  | Cucumis anguria | Cucurbitaceae
Burro's Tail | Horse's Tail, Donkey's Tail, Lamb's Tail  | Sedum morganianum | Crassulaceae
Buttercup Squash |   | Cucurbita maxima cv buttercup | Cucurbitaceae
Butterfly Ginger | White Ginger, Cinnamon Jasmine, Garland Flower, Ginger Lily  | Hedychium coronarium | Zingiberaceae
Butternut Squash |   | Cucurbita maxima cv butternut | Cucurbitaceae
Buzzy Lizzie | Giant Touch-Me-Not, Impatience Plant, Patient Lucy, Patient Plant, Tangerine Impatience  | Impatiens spp. | Balsaminaceae
Caeroba | Rattle Snake Plant, Peacock Plant, Zebra Plant  | Calathea insignis | Marantaceae
Calathea |   | Calathea spp. | Marantaceae
Calathea Lancifolia 2 |   | Maranta insignis | Marantaceae
Calathea Lancifolia 3 |   | Calathea insignis | Marantaceae
California Pitcher Plant | Cobra Orchid, Cobra Plant, Cobra Lily, Chrysamphora  | Darlingtonia californica | Sarraceniaceae
Callistemon Brachyandrus | Weeping Bottlebrush, Prickly Bottlebrush, Crimson Bottlebrush, Bottlebrush, Callistemon brachyandrus  | Callistemon species | Myrtaceae
Callistemon citrinus | Crimson Bottlebrush  | Callistemon citrinus | Myrtaceae
Callistemon viminalis | Weeping Bottlebrush, Prickly Bottlebrush, Crimson Bottlebrush  | Callistemon viminalis | Myrtaceae
Calochortus nuttalli | Sego Lily, Star Tulip, Mariposa Lily, Cat Ear, Butterfly Tulip  | Calochortus spp. | Liliaceae
Camellia | Common Camellia, Peony Camellia  | Camellia japonica | Theaceae
Canada Hemlock |   | Tsuga canadensis | Pinaceae
Canary Date Palm |   | Phoenix canariensis | Palmae
Candle Plant |   | Plectranthus coleoides | Lamiaceae
Candycorn Plant |   | Hypocyrta nummularia | Gesneriaceae
Cane Palm | Golden Butterfly Palm, Areca Palm, Golden Feather Palm, Yellow Palm  | Dypsis lutescens, chrysalidocarpus lutescens | alternate scientific name  | Palmae
Canna | Achira, Indian shot, African arrow root, edible canna, purple arrow root, sierra leone arrow root  | Canna indica | Cannaceae
Canna Lily | Common Garden Canna  | Canna generalis | Cannaceae
Canterbury-bell |   | Gloxinia perennis | Gesneriaceae
Cape Marigold | African Daisy  | Dimorphotheca pluvialis | Compositae
Cape Primrose | Twisted Fruit, Bavarian Belle  | Streptocarpus spp. | Gesneriaceae
Carob | Sugar Pod, Locust Pods, Algaroba, Carob Tree Kharoub, Beans  | Ceratonia siliqua | Fabaceae
Caroba | Caaroba, Carob Tree, Carobhina, Bignonia  | Jacaranda procera | Bignoniaceae
Carolina Hemlock |   | Tsuga caroliniana | Pinaceae
Carrion Flower | Jacob's Ladder  | Smilax herbacea | Liliaceae
Carrion Flower 2 | Hairy Toad Plant  | Stapelia hirsata | Asclepiadaceae
Carrot Fern |   | Onychium japonica | Polypodiaceae
Carrot Flower | Garden Carrot  | Daucus carota var. sativa | Umbelliferae
Casaba Melon | Honeydew Melon, True Cantaloupe, Muskmelon  | Cucumis melo | Cucurbitaceae
Cast Iron Plant | Bar Room Plant, Iron Plant, Variegated Cast Iron Plant  | Aspidistra elatior | Liliaceae
Cat Brier | China Root, Ti-hu-ling, Shiny Leaf Smilax  | Smilax glabra | Liliaceae
Cat Ear | Sego Lily, Star Tulip, Mariposa Lily, Cat Ear, Butterfly Tulip, Calochortus  | Calochortus spp. | Liliaceae
Cattleya Labiata | Crimson Cattleya, Ruby-lipped Cattleya  | Cattleya labiata | Orchidaceae
Celosia Globosa | Globe Amarantha, Perpetua  | Celosia globosa | Amaranthaceae
Celosia Plumosa | Cockscomb  | Celosia plumosa | Amaranthaceae
Celosia Spicata | Flamingo Feather  | Celosia spicata | Amaranthaceae
Chamaedorea | Miniature Fish Tail Dwarf Palm, Parlor Palm, Good Luck Palm  | Chamaedorea elegans | Palmae
Chaparral | Creosote Bush, Greasewood  | Larrea tridentata | Zygophyllaceae
Chervil | Garden Chervil, French Parsley  | Anthriscus cerefolium | Apiaceae
Chestnut | American Chestnut  | Castanea dentata | Fagaceae
Chicken-Gizzard | Joseph's Coat, Bloodleaf Plant  | Iresine herbstii | Amaranthaceae
Chickens and Hens | Hens and Chickens, Mother Hens and Chicks  | Echeveria elegans | Crassulaceae
Chin-lao-shu | China Root, Ti-hu-ling, Shiny Leaf Smilax, Catbrier  | Smilax glabra | Liliaceae
China Aster | Annual Aster, Aster Sinensis  | Callistephus chinensis | Compositae
China Root | Catbrier, Ti-hu-ling, Shiny Leaf Smilax  | Smilax glabra | Liliaceae
Chinese Plumbago |   | Ceratostigma willmottianum | Plumbaginaceae
Chlorophytum | Ribbon Plant, Spider Ivy, Spider Plant  | Anthericum comosum | Asparagaceae
Chlorophytum bichetti | Saint Bernard's Lily  | Chlorophytum bichetti | Liliaceae
Chocolate Soldier | Lace-Flower Vine, Episcia  | Episcia dianthiflora | Gesneriaceae
Christmas Cactus | Easter Cactus  | Schlumbergera bridgesii | Cactaceae
Christmas Dagger | Christmas Dagger Fern  | Polystichum acrostichoides | Dryopteridaceae
Christmas Orchid | Winter Cattleya  | Cattleya trianaei | Orchidaceae
Christmas Palm | Manila Palm  | Adonidia merrillii | Arecaceae
Cilantro | Coriander, Chinese Parsley, Dhania  | Coriandrum sativum | Apiaceae
Cinnamon |   | Cinnamomum zeylanicum | Lauraceae
Cinquefoil | Silver Cinquefoil, Shrubby Cinquefoil, Rough Cinquefoil, Sulfur Cinquefoil, Rock Cinquefoil  | Potentilla spp. | Rosaceae
Cirrhopetalum | Old World Orchid  | Bulbophyllum appendiculatum | Orchidaceae
Clearweed | Coolwort, Richweed  | Pilea pumila | Urticaceae
Cliff Brake | Button Fern, Green Cliff Brack, Cliff Break  | Pellaea rotundifolia | Pteridaceae
Club Moss | Cushion Moss, Irish Moss, Krauss' Spikemoss, Spreading Club Moss, Trailing Irish Moss  | Selaginella kraussiana | Selaginellaceae
Cocks Comb | Pile Wort, Lady Bleeding, Red Cocks Comb  | Amaranthus hypochondriacus | Amaranthaceae
Cocktail Orchid |   | Cattleya forbesii | Orchidaceae
Collinia Elegans | Miniature Fish Tail Dwarf Palm, Parlor Palm, Good Luck Palm  | Chamaedorea elegans | Palmae
Common Camellia | Camellia, Peony Camellia  | Camellia japonica; Thea japonica | Theaceae
Common Catbrier | Catbrier, Horsebrier, Common Greenbrier  | Smilax rotundifolia | Liliaceae
Common Garden Canna | Common Garden Canna  | Canna generalis | Cannaceae
Common Greenbrier | Catbrier, Horsebrier, Common Greenbrier  | Smilax rotundifolia | Liliaceae
Common Snapdragon | Garden Snapdragon  | Antirrhinum majus | Scrophulariaceae
Common Staghorn Fern |   | Platycerium bifurcatum | Polypodiaceae
Confederate Jasmine | Star Jasmine  | Trachelospermum jasminoides | Family:
Coolwort | Clearweed, Richweed  | Pilea pumila | Urticaceae
Copper Rose |   | Echeveria multicaulis | Crassulaceae
Coral Bells | Coral Bells, Heuchera  | Heuchera sanguinea | Saxifragaceae
Coreopsis | Tickseed  | Coreopsis spp. | Compositae
Cornflower | Bachelor's Buttons, Bluebottle  | Centaurea cyanus | Asteraceae
Crape Myrtle | Crepe Myrtle  | Lagerstroemia indica | Lythraceae
Creeping Charlie | Swedish Ivy | Plectranthus   | Pilea nummulariifolia | Lamiaceae
Creeping Gloxinia | Maurandya  | Asarina erubescens | Scrophulariaceae
Creeping Mahonia | Tall Mahonia, Mountain Grape, Oregon Grape, Oregon Holly, Holly-leaved Barberry  | Mahonia aquifolium | Berberidaceae
Creeping Pilea | Swedish Ivy | Plectranthus , Creeping Charlie  | Pilea nummulariifolia | Pilea: Uriticaeae; Plectranthus: Lamiaceae
Creeping Rubus | Strawberryleaf Raspberry  | Rubus pedatus | Rosaceae
Creeping Zinnia |   | Sanvitalia spp. | Asteraceae
Crepe Myrtle | Crape Myrtle  | Lagerstroemia indica | Lythraceae
Crimson Bottlebush | Weeping Bottlebrush, Prickly Bottlebrush, Bottlebrush  | Callistemon species | Myrtaceae
Crimson Cup | Marbled fingernail,Blushing bromeliad, Ossifragi Vase, Miniature Marble plant, Aregelia  | Neoregalia spp. | Bromiliaceae
Crisped Feather Fern | Bold-Sword Fern  | Nephrolepis biserrata | Dryopteridaceae
Crossandra |   | Crossandra species | Acanthaceae
Cucumber | Garden Cucumber  | Cucumis sativus | Cucurbitaceae
Cushion Aloe |   | Aloe retusa | Aloaceae
Cushion Moss | Club Moss, Irish Moss, Krauss' Spikemoss, Spreading Club Moss, Trailing Irish Moss  | Selaginella kraussiana | Selaginellaceae
Cyrtudeira | Flame African Violet, Frosty, Flame, Moss agate, Lady Lou, Red African Violet, Acajou  | Episcia reptans | Gesneriaceae
Dainty Rabbits-Foot Fern | Lacy Paw, Lacy Hare's Foot  | Davallia fejeensis | Davalliaceae
Dallas Fern | Bold Sword Fern  | Nephrolepis biserrata | Dryopteridaceae
Dancing Doll Orchid |   | Oncidium flexuosum | Orchidaceae
Desert Trumpet |   | Eriogonium inflatum | Polygonaceae
Dichelostemma | Several varieties  | Dichelostemma species | Amaryllidaceae
Dichorisandra Reginae | Queen's Spiderwort  | Dichorisandra reginae | Commelinaceae
Dill |   | Anethum graveolena | Apiaceae
Dinteranthus |   | Dinteranthus vanzylii | Aizoaceae
Duffii Fern | Duffy Fern, Lemon Button Fern  | Nephrolepsis cordifolia 'duffii' | Nephrolepidaceae
Dwarf Date Palm |   | Phoenix acaulis | Palmae
Dwarf Feather Palm |   | Nephrolepis exalta | Nephrolepidaceae
Dwarf Palm | Good Luck palm, Parlor palm  | Chamaedorea elegans | Palmae
Dwarf Rose-Stripe Star |   | Cryptanthus bivattus minor | Bromelaceae
Dwarf Royal Palm |   | Veitchia merillii | Arecaceae
Dwarf Whitman Fern |   | Nephrolepsis cordifolia plumosa | Nephrolepidaceae
Earth Star | Starfish plant, Green earth star, Vary-leaf star  | Cryptanthus bivattus minor | Bromeliaceae
Easter Cattleya | Easter Orchid  | Cattleya mossiae | Orchidaceae
Easter Daisy |   | Townsendia sericea | Asteraceae
Easter Lily Cactus |   | Echinopsis multiplex | Cactaceae
Easter Orchid | Easter Cattleya  | Cattleya mossiae | Orchidaceae
Edible Banana |   | Musa acuminata | Musaceae
Emerald Ripple Peperomia | Green ripple peperomia, Little fantasy peperpmia  | Peperomia caperata | Piperaceae
English Hawthorn | Midland hawthorn, Smooth hawthorn  | Crataegus laevigata | Rosaceae
Episcia | Lace-Flower Vine, Chocolate Soldier  | Episcia dianthiflora | Gesneriaceae
Fairy Fountain | Feathered Amaranth, Woolflower  | Celosia cristata | Amaranthaeceae
False Aralia |   | Dizygotheca elegantissima | Araliaceae
Fan Tufted Palm | Lady Palm  | Rhapis flabelliformis | Araceae
Feather Palm |   | Nephrolepis exaltata | Nephrolepidaceae
Fennel | Florence Fennel, Finocchio  | Foeniculum vulgare | Umbelliferae
Fiery Reed Orchid |   | Epidendrum ibaguense | Orchidaceae
Fig Leaf Gourd | Malabar Gourd  | Cucurbita ficifolia | Cucurbitaceae
Figleaf Palm | Formosa rice tree, Glossy-leaved paper plant, Big-leaf paper plant  | Fatsia japonica | Araliaceae
Fingernail Plant |   | Neoregelia spectabilis | Bromeliaceae
Fire Weed | Blooming Sally, Great Willow-Herb  | Epilobium angustifolium | Onagraceae
Fish Tail Fern |   | Cyrtomium falcatum | Polypodaceae
Flame African Violet | Flame violet, Red violet  | Episcia reptans | Gesneriaceae
Flame of the Woods | Maui sunset  | Ixora coccinea | Rubiaceae
Florida Butterfly Orchid | Encyclia tampensis  | Butterfly orchid  | Encyclia tampensis | Orchidaceae
Florida Butterfly Orchid | Epidendrum tampense  | Scarlet Orchid  | Epidendrum tampense | Orchidaceae
Fluffy Ruffles |   | Nephrolepsis exalta | Family:
Forster Sentry Palm | Kentia palm  | Howea forsteriana | Palmea
Fortunes Palm | Chusan palm  | Trachycarpus fortunei | Palmae
Freckle Face | Polka Dot Plant, Measles Plant, Flamingo Plant, Baby’s Tears  | Hypoestes phyllostachya | Acanthaceae
Friendship Plant |   | Pilea involucrata | Pilaceae
Garden Marigold | Marigold, Mary Bud, Gold bloom, Pot marigold  | Calendula officinalis | Compositae
Garden Snapdragon |   | Antirrhinum majus | Scrophulariaceae
Gerber Daisy | Transvaal Daisy, African Daisy, Veldt Daisy, Gerbera Daisy, Barberton Daisy  | Gerbera jamesonii | Compositae
German Violet | Arabian gentian, Persian violet  | Exacum affine | Gentianaceae
Gherkins | Immature cucumbers  | Cucumis sativus | Cucurbitaceae
Ghost Leafless Orchid | Leafless ghost orchid  | Polyrrhiza lindenii | Orchidaceae
Ghost Plant | Mother of Pearl  | Sedum weinbergii | Crassulaceae
Giant Aster |   | Townsendia sericea | Asteraceae
Giant Holly Fern | Sword fern, Wester sword, imbricate sword fern  | Ploystichum munitum | Polypodaceae
Giant Touch-Me-Not | Buzzy Lizzie, Impatience Plant, Patient Lucy, Patient Plant, Tangerine Impatience  | Impatiens spp. | Balsaminaceae
Giant White Inch Plant |   | Albiflora spp. | Commelinaceae
Globe Thistle |   | Echinops spp. | Asteraceae
Gloxinia |   | Sinningia speciosa | Gesneriaceae
Gold Bloom | Marigold, Mary Bud, Garden Marigold, Pot Marigold  | Calendula officinalis | Compositae
Gold-Fish Plant | Candy Corn Plant  | Hypocyrta nummularia | Gesneriaceae
Golden Bells | Forsythia  | Oleaceae | Family:
Golden Butterfly Palm | Areca Palm, Cane Palm, Golden Feather Palm, Yellow Palm  | Dypsis lutescens | Palmae
Golden Lace Orchid | Jewel Orchid  | Haemaria discolor | Orchidaceae
Golden Shower Orchid |   | Oncidium sphacelatum | Orchidaceae
Good Luck Palm | Dwarf Palm, Parlor Palm  | Chamaedorea elegans | Palmae
Grape Hyacinth |   | Muscari armeniacum | Liliaceae
Grape Ivy | Venezuela treebine  | Cissus rhombifolia | Vitaceae
Great Willow Herb | Blooming Sally, Fire Weed  | Epilobium angustifolium | Onagraceae
Green Ripple Peperomia | Emerald Ripple Peperomia, Little Fantasy Peperpmia  | Peperomia caperata | Piperaceae
Greenbrier | China Root, Ti-hu-ling, Shiny Leaf Smilax, cat brier  | Smilax glabra | Liliaceae
Hagbrier | Hellfetter  | Smilax hispida | Liliaceae
Hardy Baby Tears | Stonecrop  | Sedum album | Crassulaceae
Hardy Gloxinia |   | Incarvillea delavayi | Bignoniaceae
Hare Fern | Rabbit's Foot Fern, Squirrel Foot Fern, Deer Foot Fern, Ball Fern  | Davallia spp. | Polypodiaceae
Haworthia | Many cultivars  | Haworthia species | Liliaceae
Haws | Pirliteiro  | Crataegus species | Rosaceae
Haws Apple | Haws, Hawthorn  | Crataegus species | Rosaceae
Hawthorn | Haws, Haws Apple  | Crataegus species | Rosaceae
Hedgehog Gourd | Teasel Gourd  | Cucumis dipsaceus | Cucurbitaceae
Hellfetter | Hellfetter  | Smilax hispida | Liliaceae
Hemlock Tree | Many varieties  | Tsuga species | Pinaceae
Hen and Chickens Fern | King and queen fern, Spleenwort, Parsley fern  | Asplenium bulbiferum | Polypodaceae
Hens and Chickens | Chickens and Hens, Mother Hens and Chicks  | Echeveria elegans | Crassulaceae
Hibiscus | Rose of Sharon, Rose of China  | Hibiscus syriacus | Malvaceae
Hindu Rope Plant |   | Hoya carnosa 'krinkle kurl' | Asclepiadaceae
Hoary Alyssum |   | Berteroa incana | Brassicaceae
Holligold | Marigold, Mary Bud, Gold Bloom, Pot Marigold, Garden Marigold  | Calendula officinalis | Compositae
Holly Fern | Fishtail Fern  | Cyrtomium falcatum | Polypodaceae
Hollyhock |   | Alcea rosea | Malvaceae
Honey Locust |   | Gleditsia triacanthos | Fabaceae
Honey Plant | Wax Plant  | Hoya carnosa | Asclepiadaceae
Honeydew Melon | Casaba Melon  | Cucumis melo | Cucurbitaceae
Honeysuckle Fuchsia |   | Fuchsia triphylla | Onagraceae
Hookera pulchella | Wild Hyacinth, Blue-Dicks  | Dichelostemma pulchellum | Amaryllidaceae
Hubbard Squash |   | Cucurbita maxima var. hubbard | Cucurbitaceae
Hypocyrta | Candy Corn Plant, Goldfish Plant  | Hypocyrta nummularia | Gesneriaceae
Ice Plant |   | Lampranthus piquet | Aizoaceae
Impatience Plant | Giant Touch-Me-Not, Buzzy Lizzy, Patient Lucy, Patient Plant, Tangerine Impatience  | Impatiens spp. | Balsaminaceae
Irish Moss | Club Moss, Cushion Moss, Krauss' Spikemoss, Spreading Club Moss, Trailing Irish Moss  | Selaginella kraussiana | Selaginellaceae
Iron Tree | Maui Sunset, Flame of the Woods  | Ixora coccinea | Rubiaceae
Ivy Peperomia | Plantinum Peperomia, Silver leaf Peperomia, Ivy leaf Peperomia  | Peperomia griseoargentea | Piperaceae
Jackson Brier |   | Smilax lanceolata | Liliaceae
Jacob's Ladder | Carrion Flower  | Smilax herbacea | Liliaceae
Japanese Aralia | Formosa rice tree, Glossy-leaved paper plant, Big-leaf paper plant  | Fatsia japonica | Araliaceae
Japanese Holly Fern | Fishtail Fern, Holly Fern  | Cyrtomium falcatum | Polypodaceae
Japanese Moss | Club Moss, Cushion Moss, Krauss' Spikemoss, Spreading Club Moss, Trailing Irish Moss, Irish Moss  | Selaginella kraussiana | Selaginellaceae
Japanese Pittosporum | Australian laurel, Mock orange  | Pittosporum tobira | Pittosporaceae
Jasmine |   | Jasminum species | Oleaceae
Jewel Orchid | Golden Lace Orchid  | Haemaria discolor | Orchidaceae
Joseph's Coat | Chicken Gizzard, Yellow Bloodleaf, Bloodleaf  | Iresine herbstii | Amaranthaceae
Jungle Geranium |   | Ixora javanica | Rubiaceae
Kaempferia | Peacock Ginger  | Kaempferia spp. | Zingiberaceae
Kahali Ginger |   | Hedychium gardnerianum | Zingiberaceae
Kenilworth Ivy | Coliseum Ivy  | Cymbalaria muralis | Scrophulariaceae
Kentia Palm | Forster Senty Palm  | Howea forsteriana | Howea forsteriana
Kenya Violet | Usambra violet  | Saintpaulia confusa | Gesneraceae
Kharoub | Carob Tree, Sugar Pods, Locust Pods, Beans  | Ceratonia siliqua | Family:
King and Queen Fern | Hen and Chickens Fern, Spleenwort, Parsley fern  | Asplenium bulbiferum | Polypodaceae
King Nut |   | Carya laciniosa | Juglandaceae
King of the Forest | Golden Jewel Orchid  | Anoectuchilus setaceus | Orchidaceae
Kuang-yen-pa-hsieh | China Root, Ti-hu-ling, Shiny Leaf Smilax, Cat Brier  | Smilax glabra | Liliaceae
Lace Flower Vine | Chocolate Soldier  | Episcia dianthiflora | Gesneriaceae
Lace Orchid |   | Odontoglossum crispum | Orchidaceae
Ladies Ear Drops |   | Fuschsia spp. | Onagraceae
Lady Lou | Flame Violet, Red Violet, Flame African Violet  | Episcia reptans | Gesneriaceae
Lady Palm |   | Rhapis flabelliformus | Arecaceae
Lady Slipper | Giant Touch-Me-Not, Buzzy Lizzy, Patient Lucy, Patient Plant, Tangerine Impatience, Impatience Plant  | Impatiens spp. | Balsaminaceae
Lagerstroemia Indica | Crepe/Crape Myrtle  | Lagerstroemia indica | Lythraceae
Lance Pleomele |   | Draceana spp. | Asparagaceae
Laurel-Leaved Greenbrier | Blaspheme vine, Bamboo Vine  | Smilax laurifolia | Liliaceae
Leather Peperomia |   | Peperomia crassifolia | Piperaceae
Lemon Balm | Balm, Common Balm, Balm mint  | Melissa officinalis | Lamiaceae
Leopard Orchid | Tiger Orchid  | Dendrobium gracilicaule | Orchidaceae
Lesser Snapdragon |   | Antirrhinum orontium | Mimosaceae
Lily of the Valley Orchid |   | Odontoglossum pulchellum | Orchidaceae
Linden |   | Tilia americana | Tiliaceae
Lipstick Plant |   | Aeschynanthus humilis | Gesneraceae
Little Fantasy Peperomia | Green Ripple Peperomia, Emerald Ripple Peperomia  | Peperomia caperata | Piperaceae
Little Zebra Plant |   | Haworthia subfasciata | Aloaceae
Living Rock Cactus | African living rock, Mimicry plant  | Pleiospilos bolusii | Aizoaceae
Living Stones | Kiawe, Mesquite  | Lithops naureeniae | Aizoaceae
Loco Weed | Oxytropis spp.  | Locoweed  | Oxytropis spp. | Fabaceae
Locust Pods | Carob Tree, Sugar Pods, Kharoub, Beans  | Ceratonia siliqua | Family:
Madagascar Jasmine | Wax Flower, Bride's Flower, Clustered Wax Flower  | Stephanotis floribunda | Ascleopiadaceae
Magnolia Bush | Star Magnolia  | Magnolia stellata | Magnoliaceae
Mahonia | Oregon Grape, Oregon Grape Holly, Mahonia aguifolium, Holly-leaved berry  | Mahonia aquifolium | Berberidaceae
Majesty Palm | Majestic Palm  | Ravenea rivularis | Aracaceae
Malabar Gourd | Fig-leaf gourd  | Cucurbita ficifolia | Cucurbitaceae
Manila Palm | Dwarf Royal Palm, Christmas Palm  | Veitchia merrillii | Arecaceae
Maranta |   | Calathea insignis | Marantaceae
Marbled Fingernail | Fingernail Plant  | Neoregelia spectabilis | Bromeliaceae
Mariposa Lily | Sego Lily  | Calochortus gunnisonii | Liliaceae
Maroon | Copper Rose  | Echeveria multicaulis | Crassulaceae
Maroon Chenille Plant | Blue Echeveria, Painted Lady, Copper Rose, Wax Rosette, Plush Plant  | Echeveria derenbergii | Crassulaceae
Mary-Bud | Marigold, Garden Marigold, Gold bloom, Pot Marigold  | Calendula officinalis | Compositae
Measles Plant | Polka Dot Plant, Flamingo Plant, Baby’s Tears, Freckle Face  | Acantha | Acanthaceae
Metallic Peperomia |   | Peperomia caperata | Piperaceae
Mexican Firecracker |   | Echeveria Pulinata | Crassulaceae
Mexican Rosettes |   | Echevaria | Crassulaceae
Mexican Snowballs |   | Echevaria | Crassulaceae
Miniature Date Palm | Pygmy Date Palm, Robellini Palm  | Phoenix robellinii | Arecaceae
Miniature Fish Tail | Parlor Palm  | Chamaedorea elegans | Palmae
Miniature Maranta |   | Calathea micans | Saxifragaceae
Miniature Marble Plant |   | Neoregelia spectabilis | Bromeliaceae
Mistletoe Cactus |   | Rhipsalis cassutha | Cactaceae
Mockernut Hickory | Squarenut  | Carya tomentosa | Juglandaceae
Money Tree | Money Plant  | Pachira aquatica | Malvaceae
Mosaic Plant | Jewel Plant, Siver Nerve, Nerve Plant, Silver Threads  | Bertolonia mosaica | Melastomataceae
Mosaic Vase |   | Guzmania musaica | Bromeliaceae
Moss Agate | Flame Violet, Red Violet, Flame African Violet, Lady Lou  | Episcia reptans | Gesneriaceae
Moss Campion | Bladder Campion, Cushion Pink, Dwarf Silene, Catchfly  | Silene acaulis | Caryophyllaceae
Moss Fern | Club Moss, Irish Moss, Krauss' Spikemoss, Spreading Club Moss, Trailing Irish Moss, Cushion Moss  | Selaginella kraussiana | Selaginellaceae
Moss Phlox |   | Phlox subulata | Polemoniaceae
Mossy Campion | Bladder Campion, Cushion Pink, Dwarf Silene, Catchfly, Moss Campion  | Silene acaulis | Caryophyllaceae
Mother Fern | King and Queen Fern, Spleenwort, Parsley Fern, Hen and Chickens Fern  | Asplenium bulbiferum | Polypodaceae
Mother of Pearl | Ghost Plant  | Secum weinbergii | Crassulaceae
Mother Spleenwort | King and Queen Fern, Spleenwort, Parsley Fern, Hen and Chickens Fern, Mother Fern  | Asplenium bulbiferum | Polypodaceae
Mountain Camellia | Showy Camellia  | Stewartia ovata | Theaceae
Mountain Grape | Oregon Grape, Oregon Grape Holly, Mahonia Aguifolium, Holly-Leaved Berry, Mahonia  | Mahonia aquifolium | Berberidaceae
Mulberry Bush Greenbrier |   | Smilax sp. | Liliaceae
Mulberry Tree |   | Morus sp. | Moraceae
Musa Paradisiaca | Banana, Edible Banana, Plantain  | Musa acuminata | Musaceae
Muscari Armeniacum | Grape Hyacinth  | Muscari armeniacum | Hyacinthaceae
Muskmelon |   | Cucumis melo | Cucurbiaceae
Nasturtium | Nose-Twister, Nose-Tweaker  | Tropaeolum majus | Tropaeolaceae
Natal Plum |   | Carissa grandiflora | Apocynaceae
Neanthe Bella Palm | Neanthebella  | Chamaedorea elegans | Araceae
Nematanthus spp. | Candy Corn Plant  | Hypocyrta nummularia | Gesneriaceae
Neoregelia | Crimson Cup, Marbled Fingernail, Blushing Bromeliad, Ossifragi Vase, Miniature Marble Plant, Aregelia  | Neoregalia spp. | Bromiliaceae
Nerve Plant | Jewel Plant, Silver Nerve, Mosaic Plant, Silver Threads  | Fittonia verschaffeltii | Acanthaceae
Night Blooming Cereus | Queen of the Night, Pitaya, Honolulu Queen  | Hylocereus undatus | Cactaceae
Old Man Cactus |   | Cephalocereus senilis | Cactaceae
Old World Orchid | Cirrhopetalum  | Bulbophyllum appendiculatum | Orchidaceae
Orange Star |   | Guzmania lingulata minor | Bromeliaceae
Oregon Grape | Mountain Grape, Oregon Grape Holly, Mahonia Aguifolium, Holly-Leaved Berry, Mahonia  | Mahonia aquifolium | Berberidaceae
Ossifragi Vase | Crimson Cup, Marbled Fingernail, Blushing Bromeliad, Neoregelia, Miniature Marble Plant, Aregelia  | Neoregalia spp. | Bromiliaceae
Paddys Wig | Japanese moss, Peace-in-the-home, Corsican Carpet, Angel's Tears, Irish Moss, Mind-your-own-business, Pollyanna vine, Baby Tears  | Soleirolia soleirolii | Urticaceae
Painted Lady | Copper Rose  | Echeveria multicaulis | Crassulaceae
Pampas Grass |   | Cortaderia selloana | Poaceae
Panamiga | Friendship Plant  | Pilea involucrata | Urticaceae
Pansy Orchid |   | Miltonia roezlii alba | Orchidaceae
Paradise Palm | Kentia palm, Forster Senty Palm  | Howea forsteriana | Howea forsteriana
Parlor Palm | Miniature Fish Tail Dwarf Palm, Good Luck Palm, Bamboo Palm  | Chamaedorea elegans | Palmae
Parsley Fern | King and Queen Fern, Spleenwort, Mother Fern, Hen and Chickens Fern  | Asplenium bulbiferum | Polypodaceae
Patient Lucy | Giant Touch-Me-Not, Impatience Plant, Patient Plant, Tangerine Impatience, Buzzy Lizzie  | Impatiens spp. | Balsaminaceae
Patient Plant | Giant Touch-Me-Not, Impatience Plant, Patient Lucy, Tangerine Impatience, Buzzy Lizzie  | Impatiens spp. | Balsaminaceae
Peacock Plant | Peacock Ginger, Kaempferia  | Kaempferia | Zingiberaceae
Pearl Plant |   | Haworthia margaritifera | Liliaceae
Pearly Dots |   | Haworthia margaritifera | Liliaceae
Peperomia Hederifolia | Plantinum Peperomia, Silver Leaf Peperomia, Ivy Leaf Peperomia, Ivy Peperomia  | Peperomia griseoargentea | Piperaceae
Peperomia Peltfolia |   | Peperomia peltifolia | Piperaceae
Peperomia Rotundifolia |   | Peperomia rotundifolia | Piperaceae
Peperomia Sandersii |   | Peperomia sandersii | Piperaceae
Pepper Face | Baby Rubber Plant, American Rubber Plant  | Peperomia obtusifolia | Pipericeae
Persian Violet | Arabian gentian, German Violet  | Exacum affine | Gentianaceae
Peruvian Lily | Lily of the Incas, Princess Lily, Alstromeria  | Alstroemeria | Liliaceae
Petunia |   | Petunia species | Solanaceae
Phalaenopsis Orchid | Moth Orchid, Moon Orchid  | Phalaenopsis sp. | Orchidaceae
Pheasant Plant | Zebra Plant  | Cryptanthus zonatus | Bromeliaceae
Piggy Back Plant | Pick-a-back plant, Mother of Thousands, Curiosity plant  | Tolmeia menziesii | Saxifragaceae
Pignut Hickory |   | Carya glabra | Juglandaceae
Pilea Microphylla | Artillery Plant  | Pilea microphylla | Urticaceae
Pilea Mucosa | Artillery Plant  | Pilea microphylla | Urticaceae
Pincushion Flower |   | Leucospermum incisum | Protaeceae
Pink Brocade |   | Episcia cultivar | Gesneriaceae
Pink Splash | Flamingo Plant, Polka Dot Plant, Measles Plant, Baby’s Tears, Freckle Face  | Hypoestes phyllostachya | Acanthaceae
Pink Starlite | Starfish Plant, Green Earth Star, Vary-Leaf Star, Earth Star, Rose-stripe Star  | Cryptanthus bivattus minor | Bromeliaceae
Pirliteiro | Haws  | Crataegus species | Rosaceae
Pitaya | Queen of the Night, Night Blooming Cereus, Honolulu Queen  | Hylocereus undatus | Cactaceae
Plantanus Occidentalis | oriental plane  | Plantanus occidentalis | Plantanaceae
Platinum Peperomia | Ivy Peperomia, Silver Leaf Peperomia, Ivy Leaf Peperomia  | Peperomia griseoargentea | Piperaceae
Platycerium Alcicorne | Staghorn Fern  | Platycerium alcicorne | Polypodaceae
Plumbago Larpentiae |   | Ceratostigma larpentiae | Plumbaginaceae
Plush Plant |   | Echeveria pul-oliver | Crassulaceae
Poison Ivy | poison oak, poison sumac  | Toxicodendron species | Anacardiaceae
Poison Oak | Similar: Poison Ivy, Poison Sumac  | Toxicodendron species | Anacardiaceae
Poison Sumac | Similar: Poison Ivy, Poison Oak  | Toxicodendron species | Anacardiaceae
Polka Dot Plant | Pink Polka Dot Plant, Measles Plant, Baby’s Tears, Freckle Face  | Hypoestes phyllostachya | Acanthaceae
Polystichum Falcatum | Fishtail Fern  | Cyrtomium falcatum | Polypodaceae
Pony Tail | Elephant-Foot Tree, Pony Tail Plant, Bottle Palm  | Beaucarnea recurvata | Agavaceae
Porcelain Flower | Hindu Rope Plant  | Hoya carnosa 'krinkle kurl' | Asclepiadaceae
Pot Marigold | Marigold, Mary Bud, Gold bloom  | Calendula officinalis | Compositae
Prairie Lily | giant rain lily, hill country rain lily  | Zephyranthes drummondii | Amaryllidaceae
Prayer Plant | Maranta, Peacock Plant, Rattle Snake Plant, Red Veined Prayer, Zebra Plant  | Calathea insignis | Marantaceae
Prostrate Coleus |   | Plectranthus oetendahlii | Lamiaceae
Pupleosier Willow |   | Salix purpurea | Saliaceae
Purple Baby Tears | fairy elephant's feet  | Frithia pulchra | Aizoaceae
Purple Passion Vine | Velvet Plant, Royal Velvet Plant, Purple Velvet Plant  | Gynura aurantica | Asteraceae
Purple Velvet Plant | Velvet Plant, Royal Velvet Plant, Purple Passion Vine  | Gynura aurantica | Asteraceae
Purple Waffle Plant | waffle plant  | Hemigraphis exotica | Acanthaceae
Queencup | Bride's Bonnet  | Clintonia uniflora | Liliaceae
Queens Spiderwort |   | Dichorisandra reginae | Commelinaceae
Queensland Arrowroot | Achira, Canna, Arrowroot  | Canna edulis | Cannaceae
Rabbits Foot Fern | Hare Fern, Squirrel Foot Fern, Deer Foot Fern, Ball Fern  | Davallia spp. | Polypodiaceae
Rainbow Orchid |   | Epidendrum prismatocarpum | Orchidaceae
Red African Violet | Flame African Violet  | Episcia reptans | Gesneriaceae
Red Berried Greenbrier | red-berried-bamboo  | Smilax walteria | Liliaceae
Red Edge Peperomia |   | Peperomia clusiifolia | Piperaceae
Red Hawthorne | Haws, Pirliteiro  | Crataegus species | Rosaceae
Red Maple | Swamp Maple, Scarlet Maple, Water Maple, Soft Maple  | Acer rubrum | Sapindaceae
Red Palm Lily | Red Fruited Palm Lily  | Cordyline rubra | Agavaceae
Red Veined Prayer | Maranta, Prayer Plant  | Calathea insignis | Marantaceae
Reed Palm | Bamboo palm, Miniature Fish Tail Dwarf Palm, Parlor Palm, Good Luck Palm  | Chamaedorea elegans | Palmae
Resurrection Lily | Peacock Ginger, Kaempferia  | Kaempferia | Zingiberaceae
Rhynchophorum | Pepper Face, Baby Rubber Plant, American Rubber Plant  | Peperomia obtusifolia | Pipericeae
Ribbon Plant | Chlorophytum Comosum  | anthericum, walking anthericum, spider ivy, spider plant  | Chlorophytum comosum | Liliaceae
Roosevelt Fern | Bold Sword Fern  | Nephrolepis biserrata | Dryopteridaceae
Rose |   | Rosa Species | Rosaceae
Rose of China | Hibiscus, Rose of Sharon  | Hibiscus syriacus | Malvaceae
Rose of Sharon | Hibiscus, Rose of China  | Hibiscus syriacus | Malvaceae
Rosemary | Anthos  | Rosmarinus officinalis | Lamiaceae
Russian Knapweed |   | Centaurea repens | Compositae
Russian Olive | Autumn Olive, Silverberry  | elaeagnus species | Elaeagnaceae
Saffron Spike Zebra |   | Aphelandra squarrosa | Acanthaceae
Sage | Common Sage, Garden Sage  | Salvia officinalis | Lamiaceae
Saint Bernards Lily |   | Anthericum liliago | Liliaceae
Salad Burnet | Garden Burnet, Small Burnet, Burnet  | Poterium sanguisorba | Rosaceae
Sand Lily | mountain lily, star lily  | Leucocrinum montanum | Liliaceae
Sand Verbena | Fragrant sand-verbena, snowball sand-verbena, prairie snowball  | Abronia fragrans | Nyctaginaceae
Satin Pellionia |   | Pellonia pulchra | Urticaceae
Savory | Summer  |   | Satureja hortensis | Lamiaceae
Savory | Winter  |   | Satureja hortensis | Lamiaceae
Sawbrier | Wild Sasparilla  | Smilax glauca | Liliaceae
Scabious | Pincushion Flower  | Leucospermum incisum | Protaeceae
Scarborough Lily |   | Vallota speciosa | Amaryllidaceae
Scarlet Orchid | Florida Butterfly Orchid  | Epidendrum tampense | Orchidaceae
Scarlet Sage | Texas Sage  | Salvia coccinea | Labiatae
Sego Lily | Mariposa Lily  | Calochortus gunnisonii | Liliaceae
Shagbark Hickory | Big Shellbark Hickory, Shellbark Hickory, Big Shagbark Hickory  | Carya laciniosa | Juglandaceae
Shan Ku'ei-lai | Cat Brier, China Root, Ti-hu-ling, Shiny Leaf Smilax  | Smilax glabra | Liliaceae
Shellbark Hickory | Big Shellbark Hickory  | Carya laciniosa | Juglandaceae
Shrimp Cactus |   | Schlumbergera russelliana | Cactaceae
Silver Bell | opossum wood, snowbell tree, shittimwood  | Halesia carolina | Styrnaceae
Silver Berry | Autumn Olive, Russian Olive  | elaeagnus species | Elaeagnaceae
Silver Heart |   | Peperomia caperata | Piperaceae
Silver Pink Vine |   | Hoya publcalyx | Asclepiadaceae
Silver Star | Cape Marigold  | Cryptanthus lacerdae | Bromeliaceae
Silver Table Fern |   | Pteris sp. | Pteridaceae
Silver Tree Anamiga |   | NONE LISTED | Family:
Slender Deutzia |   | Deutzia gracilis | Saxifragaceae
Small Fruited Hickory |   | Carya glabra | Juglandaceae
Smilax Tamnoides Vas | Hellfetter, Hagbrier  | Smilax hispida | Liliaceae
Speckled Wood Lily |   | Clintonia umbelluata | Liliaceae
Spice Orchid | Epidendrum atropurpeum  |   | Epidendrum atropurpeum | Orchidaceae
Spice Orchid | Epidendrum ibaguense  | Fiery Reed Orchid  | Epidendrum ibaguense | Orchidaceae
Spider Flower |   | Cleome hasserlana | Capparaceae
Spider Ivy | Ribbon Plant, Anthericum, Spider Ivy  | Chlorophytum comosum | Liliaceae
Spider Plant | Ribbon Plant, Anthericum, Spider Ivy  | Chlorophytum comosum | Asparagaceae
Star Jasmine |   | Trachelospermum jasminoides | Apocynaceae
Star Lily | Mountain Lily, Sand Lily  | Leucocrinum montanum | Liliaceae
Star Plant | Starfish Plant, Green Earth Star, Vary-Leaf Star, Pink Starlite  | Cryptanthus bivattus minor | Bromeliaceae
Stevia | Sweetleaf, Sugar Leaf  | Stevia rebaudiana | Asteraceae
Strawberry | wild strawberry  | Fragaria spp. | Rosaceae
Striped Blushing | Crimson Cup, Marbled Fingernail, Blushing Bromeliad, Neoregelia, Miniature Marble Plant, Aregelia  | Neoregalia spp. | Bromiliaceae
Sudan Grass | Hybrid Sudan  | Sorghum vulgare var sudanesis | Gramineae
Sugar Pods | Carob Tree, Locust Pods, Kharoub, Beans  | Ceratonia siliqua | Family:
Sulfur Flower | Umbrella Plant, Wild Buckweat  | Eriogonium umbellatum | Polygonaceae
Summer Hyacinth |   | Galtonia spp. | Hyacinthaeae
Sunflower | swamp sunflower  | helianthus angustifolius | Compositae
Swamp Sunflower | Sunflower  | helianthus angustifolius | Compositae
Swedish Ivy | Creeping Charlie  | Plectranthus australis | Pilea: Uriticaeae; Plectranthus: Lamiaceae
Sweet Pea | Perennial Pea, Everlasting Pea  | Lathyrus latifolius | Fabaceae
Sweet Potato Vine | Sweet potato  | Ipomoea batatas | Convolvulaceae
Sweetheart Hoya | wax hearts, valentine hoya  | Hoya kerrii | Asclepiadaceae
Sword Fern | Bold Sword Fern, Roosevelt Fern  | Nephrolepis biserrata | Dryopteridaceae
Tailed Orchid |   | Masdevallia spp. | Orchidaceae
Tall Feather Fern | Bold Sword Fern, Sword Fern, Roosevelt Fern  | Nephrolepis biserrata | Dryopteridaceae
Tall Mahonia | Oregon Grape, Oregon Grape Holly, Mahonia Aguifolium, Holly-Leaved Berry, Mahonia  | Mahonia aquifolium | Berberidaceae
Tangerine Impatience | Giant Touch-Me-Not, Buzzy Lizzy, Patient Lucy, Patient Plant, Tangerine Impatience, Impatience Plant, Lady Slipper  | Impatiens spp. | Balsaminaceae
Teasel Gourd | Hedgehog Gourd  | Cucumis dipsaceus | Cucurbitaceae
Texas Sage | Scarlet Sage  | Salvia coccinea | Labiatae
Thea Japonica | Common Camellia, Peony Camellia  | Camellia japonica | Theaceae
Thimble Cactus |   | Mammillaria fragilis | Cactaceae
Thorn Apple | Weisdornbluten, Blackthorn, Black Hawthorn, Thorn Plum, Pirliteiro, Red Hawthorn, May Bush, Oxyacantha, Haw Apple, Black Haw, Aubepine  | Crataegus douglasii | Rosaceae
Thyme | Common Thyme, Garden Thyme, German Thyme  | Thymus vulgaris | Lamiaceae
Ti hu-ling | China Root, Ti-hu-ling, Shiny Leaf Smilax, Cat Brier, Kuang-yen-pa-hsieh  | Smilax glabra | Liliaceae
Tickseed | coreopsis  | Coreopsis californica | Compositae
Tiger Orchid | Golden Lace Orchid, Jewel Orchid  | Haemaria discolor | Orchidaceae
Toad Spotted Cactus |   | Stapelia variegata | Apocynaceae
Torch Lily | red hot poker, poker plant  | Kniphofia | Asphodelaceae
Tous-les-mois | Achira, Canna, Arrowroot  | Canna edulis | Cannaceae
Trailing Peperomia |   | Peperomia prostata | Piperaceae
Tree Cactus |   | Opuntia species | Cactaceae
Tree Gloxinia |   | Kohleria lindeniana | Gesneriaciae
Tropical Moss | Cushion Moss, Irish Moss, Krauss' Spikemoss, Spreading Club Moss, Trailing Irish Moss  | Selaginella kraussiana | Selaginellaceae
True Cantaloupe | cantaloupe  | Cucumis melo | Cucurbitaceae
Tu Fu-Ling | Cat Brier, China Root, Ti-hu-ling, Shiny Leaf Smilax  | Smilax glabra | Liliaceae
Tulip Poplar | tulip tree  | Liriodendron tulipifera | Magnoliaceae
Turban Squash |   | Cucurbita maxima cv turbaniformis | Cucurbitaceae
Turf Lily | lilyturf  | Liriope muscari | Asparagaceae
Umbrella Plant | Sulfur Flower, Wild Buckweat  | Eriogonium umbellatum | Polygonaceae
Urbinia Agavoides | Hens and Chickens, Mother Hens and Chicks, Chickens and Hens  | Echeveria elegans | Crassulaceae
Usambara Violet | Kenya Violet  | Santpaulia confusa | Gesneraceae
Variegated Wax Plant |   | Echeveria sp. | Family:
Velvet Plant | Velvet Plant, Royal Velvet Plant, Purple Velvet Plant, Purple Passion Vine  | Gynura aurantica | Asteraceae
Venus Fly Trap |   | Dionaea muscipula | Droseraceae
Verona Fern | Bold Sword Fern, Nephrolepis Biserrata, Verona Lace Fern  | Nephrolepis biserrata | Dryopteridaceae
Verona Lace Fern | Bold Sword Fern, Nephrolepis Biserrata, Verona Fern  | Nephrolepis biserrata | Dryopteridaceae
Vining Peperomia |   | Peperomia serpens variegata | Piperaceae
Violet Slipper Gloxinia | Bright Eyes  | Sinningia speciosa | Gesneriaceae
Waffle Plant | Purple Waffle Plant  | Hemigraphis exotica | Acanthaceae
Walking Anthericum | Ribbon Plant, Spider Plant, Spider Ivy  | Chlorophytum comosum | Liliaceae
Washington Hawthorn | Haws, Pirliteiro, Red Hawthorn  | Crataegus species | Rosaceae
Water Hickory |   | Carya aquatica | Juglandaceae
Water Hyacinth |   | Eichhornia crassipes | Pontederiaceae
Watermelon Begonia |   | Peperomia argyreia | Piperaceae
Watermelon Peperomia | Watermelon Begonia  | Peperomia argyreia | Piperaceae
Watermelon Pilea | Watermelon Plant, Aluminum Plant  | Pilea cadieri | Urticaceae
Wax Plant | Hindu Rope Plant, Porcelain Flower  | Hoya carnosa 'krinkle kurl' | Asclepiadaceae
Wax Rosette | Maroon Chenille Plant, Painted Lady, Copper Rose, Blue Echeveria, Plush Plant  | Echeveria gilva | Crassulaceae
Weeping Bottlebrush | Bottlebrush, Prickly Bottlebrush, Crimson Bottlebrush  | Callistemon species | Myrtaceae
Weeping Sargent Hemlock | Many varieties  | Tsuga species | Pinaceae
Weisdornbluten | Haws, Pirliteiro, Red Hawthorn, Washington Hawthorn  | Crataegus species | Rosaceae
West Indian Gherkin | Goareberry Gourd, Gooseberry Gourd, Burr Gourd  | Cucumis anguria | Cucurbitaceae
Western Sword | Sword Fern, Giant Holly Fern, Imbricate Sword Fern  | Ploystichum munitum | Polypodaceae
White Edged Swedish Ivy | Creeping Charlie, Swedish Ivy  | Plectranthus australis | Pilea: Uriticaeae; Plectranthus: Lamiaceae
White Ginger | Butterfly Ginger, Cinnamon Jasmine, Garland Flower, Ginger Lily  | Hedychium coronarium | Family:
White Heart Hickory |   | Carya tomentosa | Juglandaceae
Whitman Fern | Bold Sword Fern, Nephrolepis Biserrata, Verona Fern, Verona Lace Fern  | Nephrolepis biserrata | Dryopteridaceae
Wild Buckwheat | Sulfur Flower, Umbrella Plant  | Eriogonium umbellatum | Polygonaceae
Wild Hyacinth | Blue Dicks  | Dichelostemma pulchellum | Amaryllidaceae
Wild Lantana | Sand Verbena, Prairie Snowball  | Abronia fragrans | Nyctaginaceae
Wild Sasparilla | Sawbrier  | Smilax glauca | Liliaceae
Wild Strawberry | Strawberry  | Fragaria | Rosaceae
Willow Herb | Blooming Sally, Fire Weed  | Epilobium angustifolium | Onagraceae
Windmill Palm | Chusan Palm  | Trachycarpus fortunei | Palmea
Winter Cattleya | Christmas Orchid  | Cattleya trianaei | Orchidaceae
Withered Snapdragon |   | Anthirrhinum multiflorum | Schrophulariaceae
Woolflower |   | Celosia cristata | Amaranthaceae
Yellow Bloodleaf | Chicken Gizzard, Bloodleaf, Joseph's Coat  | Iresine herbstii | Amaranthaceae
Yellow Palm | Golden Butterfly Palm, Cane Palm, Golden Feather Palm, Yellow Palm  | Dypsis lutescens | Palmae
Yellow-Flowered Gourd |   | Cucurbita species | Cucurbitaceae
Yellowrocket |   | Barbarea vulgaris | Brassicaceae
Yorba Linda |   | Peperomia rotundifolia | Piperaceae
Zebra Haworthia |   | Haworthia fasciata | Liliaceae
Zinnia |   | Zinnia species | Asteraceae
Zucchini Squash |   | Cucurbia pepo cv zucchini | Cucurbitaceae